OBJECTID,VACCINATION_DATE,Gender,FirstDoseDaily,FirstDoseCumulative,SecondDoseDaily,SecondDoseCumulative,SingleDoseDaily,SingleDoseCumulative
1,2020/12/14 15:00:00+00,Female,15,15,,0,,0
2,2020/12/15 15:00:00+00,Female,43,58,2,2,,0
3,2020/12/16 15:00:00+00,Female,351,409,5,7,,0
4,2020/12/17 15:00:00+00,Female,784,1193,8,15,,0
5,2020/12/18 15:00:00+00,Female,2024,3217,10,25,,0
6,2020/12/19 15:00:00+00,Female,598,3815,7,32,,0
7,2020/12/20 15:00:00+00,Female,249,4064,3,35,,0
8,2020/12/21 15:00:00+00,Female,2558,6622,24,59,,0
9,2020/12/22 15:00:00+00,Female,4246,10868,26,85,,0
10,2020/12/23 15:00:00+00,Female,4015,14883,29,114,,0
11,2020/12/24 15:00:00+00,Female,1801,16684,12,126,,0
12,2020/12/25 15:00:00+00,Female,728,17412,4,130,,0
13,2020/12/26 15:00:00+00,Female,1267,18679,8,138,,0
14,2020/12/27 15:00:00+00,Female,1274,19953,9,147,,0
15,2020/12/28 15:00:00+00,Female,6320,26273,42,189,,0
16,2020/12/29 15:00:00+00,Female,7521,33794,47,236,,0
17,2020/12/30 15:00:00+00,Female,8429,42223,81,317,,0
18,2020/12/31 15:00:00+00,Female,4904,47127,36,353,,0
19,2021/01/01 15:00:00+00,Female,2492,49619,122,475,,0
20,2021/01/02 15:00:00+00,Female,2135,51754,16,491,,0
21,2021/01/03 15:00:00+00,Female,2380,54134,43,534,,0
22,2021/01/04 15:00:00+00,Female,8949,63083,236,770,,0
23,2021/01/05 15:00:00+00,Female,8377,71460,392,1162,,0
24,2021/01/06 15:00:00+00,Female,10031,81491,545,1707,,0
25,2021/01/07 15:00:00+00,Female,10149,91640,1176,2883,,0
26,2021/01/08 15:00:00+00,Female,10964,102604,1883,4766,,0
27,2021/01/09 15:00:00+00,Female,3448,106052,662,5428,,0
28,2021/01/10 15:00:00+00,Female,1921,107973,267,5695,,0
29,2021/01/11 15:00:00+00,Female,8809,116782,2301,7996,,0
30,2021/01/12 15:00:00+00,Female,10807,127589,3797,11793,,0
31,2021/01/13 15:00:00+00,Female,11944,139533,2784,14577,,0
32,2021/01/14 15:00:00+00,Female,11602,151135,1324,15901,,0
33,2021/01/15 15:00:00+00,Female,13302,164437,1437,17338,,0
34,2021/01/16 15:00:00+00,Female,3939,168376,1079,18417,,0
35,2021/01/17 15:00:00+00,Female,1489,169865,1034,19451,,0
36,2021/01/18 15:00:00+00,Female,4524,174389,2335,21786,,0
37,2021/01/19 15:00:00+00,Female,10426,184815,3872,25658,,0
38,2021/01/20 15:00:00+00,Female,12787,197602,3849,29507,,0
39,2021/01/21 15:00:00+00,Female,14699,212301,2715,32222,,0
40,2021/01/22 15:00:00+00,Female,18061,230362,2569,34791,,0
41,2021/01/23 15:00:00+00,Female,6541,236903,1343,36134,,0
42,2021/01/24 15:00:00+00,Female,2077,238980,1234,37368,,0
43,2021/01/25 15:00:00+00,Female,10112,249092,5976,43344,,0
44,2021/01/26 15:00:00+00,Female,10724,259816,5885,49229,,0
45,2021/01/27 15:00:00+00,Female,14990,274806,8418,57647,,0
46,2021/01/28 15:00:00+00,Female,13867,288673,6288,63935,,0
47,2021/01/29 15:00:00+00,Female,15258,303931,5567,69502,,0
48,2021/01/30 15:00:00+00,Female,11118,315049,1813,71315,,0
49,2021/01/31 15:00:00+00,Female,2268,317317,849,72164,,0
50,2021/02/01 15:00:00+00,Female,5198,322515,3593,75757,,0
51,2021/02/02 15:00:00+00,Female,7384,329899,8931,84688,,0
52,2021/02/03 15:00:00+00,Female,10951,340850,11518,96206,,0
53,2021/02/04 15:00:00+00,Female,13285,354135,10427,106633,,0
54,2021/02/05 15:00:00+00,Female,12511,366646,12113,118746,,0
55,2021/02/06 15:00:00+00,Female,7233,373879,4414,123160,,0
56,2021/02/07 15:00:00+00,Female,3690,377569,1352,124512,,0
57,2021/02/08 15:00:00+00,Female,7898,385467,8380,132892,,0
58,2021/02/09 15:00:00+00,Female,9993,395460,8745,141637,,0
59,2021/02/10 15:00:00+00,Female,11772,407232,13518,155155,,0
60,2021/02/11 15:00:00+00,Female,13866,421098,10574,165729,,0
61,2021/02/12 15:00:00+00,Female,12642,433740,12742,178471,,0
62,2021/02/13 15:00:00+00,Female,6741,440481,4072,182543,,0
63,2021/02/14 15:00:00+00,Female,4290,444771,1305,183848,,0
64,2021/02/15 15:00:00+00,Female,6924,451695,8696,192544,,0
65,2021/02/16 15:00:00+00,Female,9726,461421,13010,205554,,0
66,2021/02/17 15:00:00+00,Female,12764,474185,16512,222066,,0
67,2021/02/18 15:00:00+00,Female,1756,475941,2801,224867,,0
68,2021/02/19 15:00:00+00,Female,5871,481812,12445,237312,,0
69,2021/02/20 15:00:00+00,Female,6069,487881,13115,250427,,0
70,2021/02/21 15:00:00+00,Female,3610,491491,4693,255120,,0
71,2021/02/22 15:00:00+00,Female,4575,496066,9584,264704,,0
72,2021/02/23 15:00:00+00,Female,9084,505150,9853,274557,,0
73,2021/02/24 15:00:00+00,Female,10578,515728,15040,289597,,0
74,2021/02/25 15:00:00+00,Female,11955,527683,16179,305776,,0
75,2021/02/26 15:00:00+00,Female,15692,543375,16239,322015,,0
76,2021/02/27 15:00:00+00,Female,9500,552875,7053,329068,,0
77,2021/02/28 15:00:00+00,Female,9147,562022,3083,332151,,0
78,2021/03/01 15:00:00+00,Female,15928,577950,7788,339939,,0
79,2021/03/02 15:00:00+00,Female,13770,591720,7906,347845,17,17
80,2021/03/03 15:00:00+00,Female,17147,608867,11208,359053,95,112
81,2021/03/04 15:00:00+00,Female,17538,626405,11018,370071,2273,2385
82,2021/03/05 15:00:00+00,Female,17289,643694,12271,382342,2679,5064
83,2021/03/06 15:00:00+00,Female,10871,654565,5921,388263,3298,8362
84,2021/03/07 15:00:00+00,Female,6762,661327,2880,391143,3750,12112
85,2021/03/08 15:00:00+00,Female,14185,675512,5071,396214,4481,16593
86,2021/03/09 15:00:00+00,Female,14557,690069,9002,405216,4350,20943
87,2021/03/10 15:00:00+00,Female,16738,706807,9763,414979,4195,25138
88,2021/03/11 15:00:00+00,Female,19667,726474,9967,424946,2295,27433
89,2021/03/12 15:00:00+00,Female,20564,747038,10900,435846,1668,29101
90,2021/03/13 15:00:00+00,Female,12573,759611,6054,441900,861,29962
91,2021/03/14 15:00:00+00,Female,9596,769207,3991,445891,536,30498
92,2021/03/15 15:00:00+00,Female,16222,785429,6640,452531,340,30838
93,2021/03/16 15:00:00+00,Female,17905,803334,7951,460482,395,31233
94,2021/03/17 15:00:00+00,Female,20529,823863,10233,470715,615,31848
95,2021/03/18 15:00:00+00,Female,22289,846152,7434,478149,721,32569
96,2021/03/19 15:00:00+00,Female,20851,867003,8991,487140,579,33148
97,2021/03/20 15:00:00+00,Female,13462,880465,6117,493257,358,33506
98,2021/03/21 15:00:00+00,Female,10184,890649,4601,497858,170,33676
99,2021/03/22 15:00:00+00,Female,17668,908317,6486,504344,457,34133
100,2021/03/23 15:00:00+00,Female,20275,928592,10363,514707,854,34987
101,2021/03/24 15:00:00+00,Female,21573,950165,12511,527218,763,35750
102,2021/03/25 15:00:00+00,Female,22728,972893,12796,540014,1221,36971
103,2021/03/26 15:00:00+00,Female,19294,992187,15691,555705,1280,38251
104,2021/03/27 15:00:00+00,Female,14011,1006198,10036,565741,1307,39558
105,2021/03/28 15:00:00+00,Female,8990,1015188,7143,572884,826,40384
106,2021/03/29 15:00:00+00,Female,15706,1030894,14926,587810,612,40996
107,2021/03/30 15:00:00+00,Female,20888,1051782,16716,604526,1011,42007
108,2021/03/31 15:00:00+00,Female,21481,1073263,19573,624099,3012,45019
109,2021/04/01 15:00:00+00,Female,22712,1095975,22707,646806,3032,48051
110,2021/04/02 15:00:00+00,Female,18339,1114314,18476,665282,3163,51214
111,2021/04/03 15:00:00+00,Female,11218,1125532,10711,675993,2340,53554
112,2021/04/04 15:00:00+00,Female,4398,1129930,5564,681557,471,54025
113,2021/04/05 15:00:00+00,Female,14887,1144817,15934,697491,3383,57408
114,2021/04/06 15:00:00+00,Female,20634,1165451,16606,714097,5377,62785
115,2021/04/07 15:00:00+00,Female,18735,1184186,18967,733064,6626,69411
116,2021/04/08 15:00:00+00,Female,21974,1206160,19958,753022,6835,76246
117,2021/04/09 15:00:00+00,Female,18098,1224258,20136,773158,7296,83542
118,2021/04/10 15:00:00+00,Female,12270,1236528,12859,786017,3847,87389
119,2021/04/11 15:00:00+00,Female,9099,1245627,7180,793197,4836,92225
120,2021/04/12 15:00:00+00,Female,12548,1258175,17927,811124,5341,97566
121,2021/04/13 15:00:00+00,Female,21441,1279616,19892,831016,153,97719
122,2021/04/14 15:00:00+00,Female,20444,1300060,20365,851381,107,97826
123,2021/04/15 15:00:00+00,Female,20547,1320607,20918,872299,80,97906
124,2021/04/16 15:00:00+00,Female,18657,1339264,20662,892961,11,97917
125,2021/04/17 15:00:00+00,Female,16224,1355488,11105,904066,3,97920
126,2021/04/18 15:00:00+00,Female,10206,1365694,8435,912501,3,97923
127,2021/04/19 15:00:00+00,Female,14333,1380027,18331,930832,30,97953
128,2021/04/20 15:00:00+00,Female,14692,1394719,22523,953355,16,97969
129,2021/04/21 15:00:00+00,Female,19282,1414001,23964,977319,6,97975
130,2021/04/22 15:00:00+00,Female,17281,1431282,22257,999576,5,97980
131,2021/04/23 15:00:00+00,Female,16069,1447351,21175,1020751,5,97985
132,2021/04/24 15:00:00+00,Female,12938,1460289,14831,1035582,20,98005
133,2021/04/25 15:00:00+00,Female,9334,1469623,4596,1040178,14,98019
134,2021/04/26 15:00:00+00,Female,12665,1482288,16444,1056622,94,98113
135,2021/04/27 15:00:00+00,Female,13310,1495598,17308,1073930,397,98510
136,2021/04/28 15:00:00+00,Female,14410,1510008,20463,1094393,502,99012
137,2021/04/29 15:00:00+00,Female,13360,1523368,20288,1114681,560,99572
138,2021/04/30 15:00:00+00,Female,14227,1537595,17293,1131974,629,100201
139,2021/05/01 15:00:00+00,Female,9771,1547366,13342,1145316,380,100581
140,2021/05/02 15:00:00+00,Female,4440,1551806,7905,1153221,302,100883
141,2021/05/03 15:00:00+00,Female,6050,1557856,13784,1167005,764,101647
142,2021/05/04 15:00:00+00,Female,6840,1564696,19782,1186787,654,102301
143,2021/04/13 15:00:00+00,Federal Entities,84295,84295,54201,54201,2952,2952
144,2021/04/14 15:00:00+00,Federal Entities,557,84852,11,54212,1,2953
145,2021/04/15 15:00:00+00,Federal Entities,623,85475,823,55035,19,2972
146,2021/04/16 15:00:00+00,Federal Entities,782,86257,1016,56051,8,2980
147,2021/04/17 15:00:00+00,Federal Entities,1136,87393,1177,57228,6,2986
148,2021/04/19 15:00:00+00,Federal Entities,1369,88762,2003,59231,9,2995
149,2021/04/20 15:00:00+00,Federal Entities,3243,92005,2158,61389,19,3014
150,2021/04/21 15:00:00+00,Federal Entities,906,92911,1206,62595,4,3018
151,2021/04/22 15:00:00+00,Federal Entities,1018,93929,458,63053,,3018
152,2021/04/23 15:00:00+00,Federal Entities,759,94688,632,63685,1,3019
153,2021/04/25 15:00:00+00,Federal Entities,992,95680,2492,66177,5,3024
154,2021/04/26 15:00:00+00,Federal Entities,1483,97163,1672,67849,1,3025
155,2021/04/29 15:00:00+00,Federal Entities,223,97386,865,68714,2,3027
156,2021/05/01 15:00:00+00,Federal Entities,1556,98942,1974,70688,14,3041
157,2021/05/02 15:00:00+00,Federal Entities,1071,100013,1875,72563,4,3045
158,2021/05/03 15:00:00+00,Federal Entities,403,100416,2165,74728,4,3049
159,2021/05/04 15:00:00+00,Federal Entities,28,100444,25,74753,,3049
160,2021/05/05 15:00:00+00,Federal Entities,365,100809,814,75567,,3049
161,2021/05/06 15:00:00+00,Federal Entities,275,101084,880,76447,3,3052
162,2021/05/07 15:00:00+00,Federal Entities,274,101358,966,77413,8,3060
163,2021/05/08 15:00:00+00,Federal Entities,297,101655,1312,78725,6,3066
164,2021/05/10 15:00:00+00,Federal Entities,338,101993,1712,80437,1,3067
165,2021/05/11 15:00:00+00,Federal Entities,18,102011,13,80450,,3067
166,2021/05/12 15:00:00+00,Federal Entities,243,102254,1124,81574,,3067
167,2021/05/14 15:00:00+00,Federal Entities,290,102544,1022,82596,2,3069
168,2021/05/15 15:00:00+00,Federal Entities,611,103155,1701,84297,4,3073
169,2021/05/17 15:00:00+00,Federal Entities,565,103720,2505,86802,11,3084
170,2021/05/18 15:00:00+00,Federal Entities,164,103884,61,86863,2,3086
171,2021/05/20 15:00:00+00,Federal Entities,885,104769,1024,87887,,3086
172,2021/05/22 15:00:00+00,Federal Entities,911,105680,1359,89246,9,3095
173,2021/05/24 15:00:00+00,Federal Entities,514,106194,1032,90278,8,3103
174,2021/05/25 15:00:00+00,Federal Entities,5,106199,1,90279,2,3105
175,2021/05/27 15:00:00+00,Federal Entities,425,106624,674,90953,1,3106
176,2021/05/28 15:00:00+00,Federal Entities,418,107042,342,91295,,3106
177,2021/05/29 15:00:00+00,Federal Entities,267,107309,344,91639,10,3116
178,2021/05/31 15:00:00+00,Federal Entities,214,107523,243,91882,3,3119
179,2021/06/01 15:00:00+00,Federal Entities,30,107553,48,91930,,3119
180,2021/06/16 15:00:00+00,Federal Entities,2042,109595,3555,95485,37,3156
181,2021/06/17 15:00:00+00,Federal Entities,22,109617,95,95580,,3156
182,2021/06/18 15:00:00+00,Federal Entities,269,109886,456,96036,4,3160
183,2021/06/19 15:00:00+00,Federal Entities,166,110052,338,96374,1,3161
184,2021/06/20 15:00:00+00,Federal Entities,161,110213,284,96658,1,3162
185,2021/06/21 15:00:00+00,Federal Entities,56,110269,120,96778,1,3163
186,2021/06/22 15:00:00+00,Federal Entities,13,110282,8,96786,1,3164
187,2021/06/23 15:00:00+00,Federal Entities,2,110284,2,96788,,3164
188,2021/06/24 15:00:00+00,Federal Entities,304,110588,355,97143,5,3169
189,2021/06/25 15:00:00+00,Federal Entities,124,110712,209,97352,1,3170
190,2021/06/27 15:00:00+00,Federal Entities,124,110836,173,97525,2,3172
191,2021/06/28 15:00:00+00,Federal Entities,146,110982,186,97711,4,3176
192,2021/06/29 15:00:00+00,Federal Entities,2,110984,2,97713,1,3177
193,2021/07/01 15:00:00+00,Federal Entities,313,111297,340,98053,8,3185
194,2021/07/02 15:00:00+00,Federal Entities,209,111506,249,98302,6,3191
195,2021/07/03 15:00:00+00,Federal Entities,97,111603,123,98425,4,3195
196,2021/07/04 15:00:00+00,Federal Entities,75,111678,98,98523,6,3201
197,2021/07/05 15:00:00+00,Federal Entities,7,111685,8,98531,,3201
198,2021/07/06 15:00:00+00,Federal Entities,18,111703,22,98553,4,3205
199,2021/07/08 15:00:00+00,Federal Entities,105,111808,155,98708,5,3210
200,2021/07/09 15:00:00+00,Federal Entities,136,111944,203,98911,9,3219
201,2021/07/10 15:00:00+00,Federal Entities,130,112074,140,99051,4,3223
202,2021/07/11 15:00:00+00,Federal Entities,145,112219,137,99188,4,3227
203,2021/07/13 15:00:00+00,Federal Entities,3,112222,1,99189,,3227
204,2021/07/14 15:00:00+00,Federal Entities,57,112279,57,99246,3,3230
205,2021/07/15 15:00:00+00,Federal Entities,56,112335,90,99336,4,3234
206,2021/07/16 15:00:00+00,Federal Entities,1012,113347,526,99862,24,3258
207,2021/07/17 15:00:00+00,Federal Entities,86,113433,116,99978,4,3262
208,2021/07/18 15:00:00+00,Federal Entities,152,113585,219,100197,10,3272
209,2021/05/05 15:00:00+00,Female,9368,1574064,18781,1205568,727,103028
210,2021/05/06 15:00:00+00,Female,8214,1582278,20453,1226021,662,103690
211,2021/05/07 15:00:00+00,Female,8568,1590846,18640,1244661,773,104463
212,2021/05/08 15:00:00+00,Female,5085,1595931,15327,1259988,447,104910
213,2021/05/09 15:00:00+00,Female,2456,1598387,6061,1266049,240,105150
214,2021/05/10 15:00:00+00,Female,4260,1602647,14962,1281011,509,105659
215,2021/05/11 15:00:00+00,Female,6048,1608695,15301,1296312,550,106209
216,2021/05/12 15:00:00+00,Female,7214,1615909,19045,1315357,728,106937
217,2021/05/13 15:00:00+00,Female,11251,1627160,16924,1332281,519,107456
218,2021/05/14 15:00:00+00,Female,12404,1639564,14650,1346931,705,108161
219,2021/05/15 15:00:00+00,Female,10758,1650322,11800,1358731,564,108725
220,2021/05/16 15:00:00+00,Female,4533,1654855,8765,1367496,400,109125
221,2021/05/17 15:00:00+00,Female,8179,1663034,12922,1380418,715,109840
222,2021/05/18 15:00:00+00,Female,10734,1673768,15284,1395702,716,110556
223,2021/05/19 15:00:00+00,Female,13927,1687695,16030,1411732,608,111164
224,2021/05/20 15:00:00+00,Female,10043,1697738,15979,1427711,704,111868
225,2021/05/21 15:00:00+00,Female,9821,1707559,15403,1443114,606,112474
226,2021/05/22 15:00:00+00,Female,8046,1715605,9672,1452786,435,112909
227,2021/05/23 15:00:00+00,Female,4241,1719846,5626,1458412,340,113249
228,2021/05/24 15:00:00+00,Female,6557,1726403,8211,1466623,529,113778
229,2021/05/25 15:00:00+00,Female,6631,1733034,9409,1476032,510,114288
230,2021/05/26 15:00:00+00,Female,9316,1742350,9816,1485848,535,114823
231,2021/05/27 15:00:00+00,Female,5866,1748216,9076,1494924,409,115232
232,2021/05/28 15:00:00+00,Female,6217,1754433,9736,1504660,538,115770
233,2021/05/29 15:00:00+00,Female,4434,1758867,5516,1510176,315,116085
234,2021/05/30 15:00:00+00,Female,2441,1761308,3046,1513222,178,116263
235,2021/05/31 15:00:00+00,Female,776,1762084,1785,1515007,106,116369
236,2021/06/01 15:00:00+00,Female,5180,1767264,8395,1523402,418,116787
237,2021/06/02 15:00:00+00,Female,5387,1772651,8506,1531908,353,117140
238,2021/06/03 15:00:00+00,Female,4055,1776706,10889,1542797,388,117528
239,2021/06/04 15:00:00+00,Female,4400,1781106,11377,1554174,418,117946
240,2021/06/05 15:00:00+00,Female,3544,1784650,9880,1564054,248,118194
241,2021/06/06 15:00:00+00,Female,1740,1786390,3656,1567710,145,118339
242,2021/06/07 15:00:00+00,Female,3531,1789921,7946,1575656,283,118622
243,2021/06/08 15:00:00+00,Female,3511,1793432,10063,1585719,317,118939
244,2021/06/09 15:00:00+00,Female,4246,1797678,12329,1598048,363,119302
245,2021/06/10 15:00:00+00,Female,3741,1801419,9827,1607875,348,119650
246,2021/06/11 15:00:00+00,Female,3855,1805274,9341,1617216,431,120081
247,2021/06/12 15:00:00+00,Female,2631,1807905,7412,1624628,214,120295
248,2021/06/13 15:00:00+00,Female,951,1808856,3747,1628375,137,120432
249,2021/06/14 15:00:00+00,Female,2929,1811785,6067,1634442,285,120717
250,2021/06/15 15:00:00+00,Female,3015,1814800,7298,1641740,346,121063
251,2021/06/16 15:00:00+00,Female,3505,1818305,9265,1651005,291,121354
252,2021/06/17 15:00:00+00,Female,3600,1821905,6362,1657367,289,121643
253,2021/06/18 15:00:00+00,Female,3532,1825437,6516,1663883,278,121921
254,2021/06/19 15:00:00+00,Female,2315,1827752,4477,1668360,218,122139
255,2021/06/20 15:00:00+00,Female,1137,1828889,2333,1670693,119,122258
256,2021/06/21 15:00:00+00,Female,2881,1831770,2741,1673434,234,122492
257,2021/06/22 15:00:00+00,Female,2762,1834532,4738,1678172,239,122731
258,2021/06/23 15:00:00+00,Female,3229,1837761,5253,1683425,266,122997
259,2021/06/24 15:00:00+00,Female,3050,1840811,4105,1687530,251,123248
260,2021/06/25 15:00:00+00,Female,3056,1843867,4405,1691935,257,123505
261,2021/06/26 15:00:00+00,Female,1892,1845759,3168,1695103,135,123640
262,2021/06/27 15:00:00+00,Female,1281,1847040,1681,1696784,55,123695
263,2021/06/28 15:00:00+00,Female,2572,1849612,3254,1700038,195,123890
264,2021/06/29 15:00:00+00,Female,2675,1852287,3416,1703454,216,124106
265,2021/06/30 15:00:00+00,Female,3006,1855293,3829,1707283,234,124340
266,2021/07/01 15:00:00+00,Female,2834,1858127,3581,1710864,205,124545
267,2021/07/02 15:00:00+00,Female,2800,1860927,3515,1714379,197,124742
268,2021/07/03 15:00:00+00,Female,1628,1862555,2035,1716414,89,124831
269,2021/07/04 15:00:00+00,Female,192,1862747,220,1716634,32,124863
270,2021/07/05 15:00:00+00,Female,1994,1864741,2042,1718676,107,124970
271,2021/07/06 15:00:00+00,Female,2411,1867152,3306,1721982,159,125129
272,2021/07/07 15:00:00+00,Female,2402,1869554,3382,1725364,153,125282
273,2021/07/08 15:00:00+00,Female,2580,1872134,3193,1728557,213,125495
274,2021/07/09 15:00:00+00,Female,2783,1874917,3454,1732011,205,125700
275,2021/07/10 15:00:00+00,Female,1722,1876639,2231,1734242,120,125820
276,2021/07/11 15:00:00+00,Female,1224,1877863,1233,1735475,64,125884
277,2021/07/12 15:00:00+00,Female,2373,1880236,2698,1738173,141,126025
278,2021/07/13 15:00:00+00,Female,2458,1882694,2521,1740694,120,126145
279,2021/07/14 15:00:00+00,Female,2483,1885177,2828,1743522,126,126271
280,2021/07/15 15:00:00+00,Female,2563,1887740,2703,1746225,113,126384
281,2021/07/16 15:00:00+00,Female,2883,1890623,2863,1749088,126,126510
282,2021/07/17 15:00:00+00,Female,1656,1892279,1715,1750803,102,126612
283,2021/07/18 15:00:00+00,Female,1032,1893311,1047,1751850,37,126649
284,2021/07/19 15:00:00+00,Female,2709,1896020,2505,1754355,156,126805
285,2021/07/20 15:00:00+00,Female,2787,1898807,2501,1756856,140,126945
286,2021/07/21 15:00:00+00,Female,2958,1901765,2599,1759455,145,127090
287,2021/07/22 15:00:00+00,Female,3090,1904855,2534,1761989,149,127239
288,2021/07/23 15:00:00+00,Female,3555,1908410,2620,1764609,173,127412
289,2021/07/24 15:00:00+00,Female,2072,1910482,1638,1766247,78,127490
290,2021/07/25 15:00:00+00,Female,1570,1912052,544,1766791,44,127534
291,2021/07/26 15:00:00+00,Female,3222,1915274,2111,1768902,155,127689
292,2021/07/27 15:00:00+00,Female,3370,1918644,2376,1771278,146,127835
293,2021/07/28 15:00:00+00,Female,3673,1922317,2266,1773544,145,127980
294,2021/07/29 15:00:00+00,Female,3680,1925997,2314,1775858,171,128151
295,2021/07/30 15:00:00+00,Female,4045,1930042,2664,1778522,195,128346
296,2021/07/31 15:00:00+00,Female,2319,1932361,1562,1780084,91,128437
297,2021/08/01 15:00:00+00,Female,1817,1934178,1118,1781202,63,128500
298,2021/08/02 15:00:00+00,Female,3709,1937887,2069,1783271,128,128628
299,2021/08/03 15:00:00+00,Female,3766,1941653,2178,1785449,184,128812
300,2021/08/04 15:00:00+00,Female,3837,1945490,2252,1787701,178,128990
301,2021/08/05 15:00:00+00,Female,4032,1949522,2337,1790038,183,129173
302,2021/08/06 15:00:00+00,Female,4236,1953758,2573,1792611,170,129343
303,2021/08/07 15:00:00+00,Female,2598,1956356,1423,1794034,83,129426
304,2021/08/08 15:00:00+00,Female,1874,1958230,997,1795031,53,129479
305,2021/08/09 15:00:00+00,Female,3513,1961743,2467,1797498,154,129633
306,2021/08/10 15:00:00+00,Female,3720,1965463,2295,1799793,139,129772
307,2021/08/11 15:00:00+00,Female,3659,1969122,2388,1802181,163,129935
308,2021/08/12 15:00:00+00,Female,3543,1972665,2441,1804622,201,130136
309,2021/08/13 15:00:00+00,Female,3736,1976401,2876,1807498,169,130305
310,2021/08/14 15:00:00+00,Female,2430,1978831,1665,1809163,103,130408
311,2021/08/15 15:00:00+00,Female,1559,1980390,1370,1810533,66,130474
312,2021/08/16 15:00:00+00,Female,2773,1983163,2677,1813210,127,130601
313,2021/08/17 15:00:00+00,Female,3445,1986608,2765,1815975,153,130754
314,2021/08/18 15:00:00+00,Female,3307,1989915,2911,1818886,181,130935
315,2021/08/19 15:00:00+00,Female,3242,1993157,2953,1821839,157,131092
316,2021/08/20 15:00:00+00,Female,3497,1996654,3424,1825263,163,131255
317,2021/08/21 15:00:00+00,Female,2184,1998838,1927,1827190,93,131348
318,2021/08/22 15:00:00+00,Female,1463,2000301,1500,1828690,33,131381
319,2021/08/23 15:00:00+00,Female,3113,2003414,3169,1831859,124,131505
320,2021/08/24 15:00:00+00,Female,3515,2006929,3244,1835103,191,131696
321,2021/08/25 15:00:00+00,Female,3579,2010508,3224,1838327,163,131859
322,2021/08/26 15:00:00+00,Female,3748,2014256,3433,1841760,162,132021
323,2021/08/27 15:00:00+00,Female,3720,2017976,3699,1845459,135,132156
324,2021/08/28 15:00:00+00,Female,2360,2020336,2411,1847870,80,132236
325,2021/08/29 15:00:00+00,Female,1667,2022003,1677,1849547,29,132265
326,2021/08/30 15:00:00+00,Female,3141,2025144,3088,1852635,99,132364
327,2021/08/31 15:00:00+00,Female,3207,2028351,3130,1855765,135,132499
328,2021/09/01 15:00:00+00,Female,2916,2031267,2920,1858685,155,132654
329,2021/09/02 15:00:00+00,Female,2968,2034235,3114,1861799,134,132788
330,2021/09/03 15:00:00+00,Female,3026,2037261,3576,1865375,126,132914
331,2021/09/04 15:00:00+00,Female,1756,2039017,2111,1867486,56,132970
332,2021/09/05 15:00:00+00,Female,1457,2040474,1332,1868818,39,133009
333,2021/09/06 15:00:00+00,Female,545,2041019,594,1869412,23,133032
334,2021/09/07 15:00:00+00,Female,2583,2043602,3618,1873030,119,133151
335,2021/09/08 15:00:00+00,Female,2490,2046092,2912,1875942,121,133272
336,2021/09/09 15:00:00+00,Female,2695,2048787,2925,1878867,120,133392
337,2021/09/10 15:00:00+00,Female,3104,2051891,3309,1882176,148,133540
338,2021/09/11 15:00:00+00,Female,1879,2053770,2084,1884260,76,133616
339,2021/09/12 15:00:00+00,Female,1385,2055155,1483,1885743,25,133641
340,2021/09/13 15:00:00+00,Female,2427,2057582,2607,1888350,102,133743
341,2021/09/14 15:00:00+00,Female,2313,2059895,2878,1891228,143,133886
342,2021/09/15 15:00:00+00,Female,2353,2062248,3018,1894246,151,134037
343,2021/09/16 15:00:00+00,Female,2335,2064583,3068,1897314,110,134147
344,2021/09/17 15:00:00+00,Female,2593,2067176,3457,1900771,136,134283
345,2021/09/18 15:00:00+00,Female,1705,2068881,2174,1902945,54,134337
346,2021/09/19 15:00:00+00,Female,1108,2069989,1378,1904323,31,134368
347,2021/09/20 15:00:00+00,Female,1931,2071920,2548,1906871,91,134459
348,2021/09/21 15:00:00+00,Female,2063,2073983,2741,1909612,100,134559
349,2021/07/19 15:00:00+00,Federal Entities,11,113596,10,100207,5,3277
350,2021/07/21 15:00:00+00,Federal Entities,4,113600,3,100210,,3277
351,2021/07/22 15:00:00+00,Federal Entities,27,113627,35,100245,,3277
352,2021/07/23 15:00:00+00,Federal Entities,12,113639,13,100258,,3277
353,2021/07/25 15:00:00+00,Federal Entities,19,113658,7,100265,,3277
354,2021/07/28 15:00:00+00,Federal Entities,,113658,1,100266,,3277
355,2021/07/29 15:00:00+00,Federal Entities,33,113691,11,100277,,3277
356,2021/07/30 15:00:00+00,Federal Entities,3,113694,2,100279,,3277
357,2021/07/31 15:00:00+00,Federal Entities,61,113755,24,100303,3,3280
358,2021/08/01 15:00:00+00,Federal Entities,1,113756,,100303,,3280
359,2021/08/03 15:00:00+00,Federal Entities,3,113759,,100303,,3280
360,2021/08/05 15:00:00+00,Federal Entities,35,113794,15,100318,,3280
361,2021/08/06 15:00:00+00,Federal Entities,,113794,30,100348,,3280
362,2021/08/07 15:00:00+00,Federal Entities,,113794,15,100363,,3280
363,2021/08/08 15:00:00+00,Federal Entities,69,113863,26,100389,,3280
364,2021/08/10 15:00:00+00,Federal Entities,1,113864,2,100391,,3280
365,2021/08/11 15:00:00+00,Federal Entities,3,113867,,100391,1,3281
366,2021/08/12 15:00:00+00,Federal Entities,1948,115815,201,100592,,3281
367,2021/08/13 15:00:00+00,Federal Entities,7,115822,5,100597,,3281
368,2021/08/14 15:00:00+00,Federal Entities,38,115860,17,100614,,3281
369,2021/08/17 15:00:00+00,Federal Entities,9,115869,1,100615,,3281
370,2021/08/18 15:00:00+00,Federal Entities,1,115870,,100615,,3281
371,2021/08/19 15:00:00+00,Federal Entities,25,115895,24,100639,1,3282
372,2021/08/20 15:00:00+00,Federal Entities,21,115916,9,100648,4,3286
373,2021/08/21 15:00:00+00,Federal Entities,72,115988,44,100692,,3286
374,2021/08/22 15:00:00+00,Federal Entities,6,115994,3,100695,,3286
375,2021/08/27 15:00:00+00,Federal Entities,28,116022,36,100731,,3286
376,2021/08/28 15:00:00+00,Federal Entities,2162,118184,1759,102490,85,3371
377,2021/08/29 15:00:00+00,Federal Entities,314,118498,245,102735,530,3901
378,2021/08/30 15:00:00+00,Federal Entities,3,118501,9,102744,671,4572
379,2021/08/31 15:00:00+00,Federal Entities,9,118510,8,102752,629,5201
380,2021/09/01 15:00:00+00,Federal Entities,129,118639,119,102871,523,5724
381,2021/09/02 15:00:00+00,Federal Entities,183,118822,161,103032,384,6108
382,2021/09/03 15:00:00+00,Federal Entities,273,119095,166,103198,686,6794
383,2021/09/04 15:00:00+00,Federal Entities,228,119323,195,103393,735,7529
384,2021/09/07 15:00:00+00,Federal Entities,338,119661,237,103630,2008,9537
385,2021/09/09 15:00:00+00,Federal Entities,18,119679,35,103665,,9537
386,2021/09/10 15:00:00+00,Federal Entities,818,120497,477,104142,1325,10862
387,2021/09/11 15:00:00+00,Federal Entities,422,120919,251,104393,417,11279
388,2021/09/12 15:00:00+00,Federal Entities,414,121333,299,104692,352,11631
389,2021/09/13 15:00:00+00,Federal Entities,199,121532,87,104779,95,11726
390,2021/09/14 15:00:00+00,Federal Entities,183,121715,59,104838,100,11826
391,2021/09/15 15:00:00+00,Federal Entities,320,122035,163,105001,44,11870
392,2021/09/16 15:00:00+00,Federal Entities,338,122373,207,105208,44,11914
393,2021/09/17 15:00:00+00,Federal Entities,375,122748,277,105485,4,11918
394,2021/09/18 15:00:00+00,Federal Entities,373,123121,234,105719,54,11972
395,2021/09/19 15:00:00+00,Federal Entities,420,123541,329,106048,8,11980
396,2021/09/20 15:00:00+00,Federal Entities,25,123566,17,106065,171,12151
397,2021/09/21 15:00:00+00,Federal Entities,13,123579,5,106070,63,12214
398,2021/09/22 15:00:00+00,Federal Entities,279,123858,182,106252,186,12400
399,2021/09/23 15:00:00+00,Federal Entities,341,124199,224,106476,247,12647
400,2021/09/24 15:00:00+00,Federal Entities,360,124559,316,106792,148,12795
401,2021/09/25 15:00:00+00,Federal Entities,395,124954,287,107079,316,13111
402,2021/09/26 15:00:00+00,Federal Entities,244,125198,242,107321,367,13478
403,2021/09/27 15:00:00+00,Federal Entities,7,125205,9,107330,273,13751
404,2021/09/29 15:00:00+00,Federal Entities,253,125458,211,107541,655,14406
405,2021/09/30 15:00:00+00,Federal Entities,311,125769,222,107763,545,14951
406,2021/10/01 15:00:00+00,Federal Entities,238,126007,276,108039,494,15445
407,2021/10/02 15:00:00+00,Federal Entities,22,126029,22,108061,88,15533
408,2021/10/03 15:00:00+00,Federal Entities,,126029,1,108062,1,15534
409,2021/10/06 15:00:00+00,Federal Entities,,126029,8,108070,9,15543
410,2021/10/07 15:00:00+00,Federal Entities,18,126047,26,108096,87,15630
411,2021/10/08 15:00:00+00,Federal Entities,7,126054,6,108102,20,15650
412,2021/10/09 15:00:00+00,Federal Entities,21,126075,32,108134,154,15804
413,2021/10/10 15:00:00+00,Federal Entities,2,126077,1,108135,16,15820
414,2021/10/14 15:00:00+00,Federal Entities,1364,127441,2089,110224,158,15978
415,2021/09/22 15:00:00+00,Female,2027,2076010,2474,1912086,94,134653
416,2021/09/23 15:00:00+00,Female,1949,2077959,2488,1914574,104,134757
417,2021/09/24 15:00:00+00,Female,2538,2080497,2954,1917528,91,134848
418,2021/09/25 15:00:00+00,Female,1678,2082175,1711,1919239,31,134879
419,2021/09/26 15:00:00+00,Female,1050,2083225,1256,1920495,18,134897
420,2021/09/27 15:00:00+00,Female,2385,2085610,1396,1921891,89,134986
421,2021/09/28 15:00:00+00,Female,2350,2087960,2364,1924255,84,135070
422,2021/09/29 15:00:00+00,Female,2360,2090320,2365,1926620,99,135169
423,2021/09/30 15:00:00+00,Female,2473,2092793,2508,1929128,101,135270
424,2021/10/01 15:00:00+00,Female,2901,2095694,2861,1931989,115,135385
425,2021/10/02 15:00:00+00,Female,1558,2097252,1471,1933460,40,135425
426,2021/10/03 15:00:00+00,Female,1074,2098326,1188,1934648,24,135449
427,2021/10/04 15:00:00+00,Female,2153,2100479,1892,1936540,86,135535
428,2021/10/05 15:00:00+00,Female,2044,2102523,1920,1938460,78,135613
429,2021/10/06 15:00:00+00,Female,2133,2104656,1919,1940379,94,135707
430,2021/10/07 15:00:00+00,Female,2284,2106940,1973,1942352,100,135807
431,2021/10/08 15:00:00+00,Female,2626,2109566,2340,1944692,110,135917
432,2021/10/09 15:00:00+00,Female,1370,2110936,1338,1946030,36,135953
433,2021/10/10 15:00:00+00,Female,961,2111897,911,1946941,14,135967
434,2021/10/11 15:00:00+00,Female,2264,2114161,1819,1948760,94,136061
435,2021/10/12 15:00:00+00,Female,1962,2116123,1883,1950643,106,136167
436,2021/10/13 15:00:00+00,Female,2100,2118223,1859,1952502,139,136306
437,2021/10/14 15:00:00+00,Female,1960,2120183,1806,1954308,107,136413
438,2021/10/15 15:00:00+00,Female,2410,2122593,2160,1956468,127,136540
439,2021/10/16 15:00:00+00,Female,1168,2123761,1107,1957575,49,136589
440,2021/10/17 15:00:00+00,Female,787,2124548,750,1958325,17,136606
441,2021/10/18 15:00:00+00,Female,2295,2126843,1892,1960217,94,136700
442,2021/10/19 15:00:00+00,Female,1740,2128583,1688,1961905,82,136782
443,2021/10/20 15:00:00+00,Female,1757,2130340,1670,1963575,85,136867
444,2021/10/21 15:00:00+00,Female,1667,2132007,1793,1965368,98,136965
445,2021/10/22 15:00:00+00,Female,2339,2134346,1992,1967360,90,137055
446,2021/10/23 15:00:00+00,Female,1364,2135710,1000,1968360,45,137100
447,2021/10/24 15:00:00+00,Female,923,2136633,703,1969063,20,137120
448,2021/10/25 15:00:00+00,Female,2317,2138950,1636,1970699,107,137227
449,2021/10/26 15:00:00+00,Female,2323,2141273,1651,1972350,115,137342
450,2021/10/27 15:00:00+00,Female,2335,2143608,1732,1974082,155,137497
451,2021/10/28 15:00:00+00,Female,2276,2145884,1733,1975815,121,137618
452,2021/10/29 15:00:00+00,Female,2409,2148293,1950,1977765,119,137737
453,2021/10/30 15:00:00+00,Female,1346,2149639,978,1978743,55,137792
454,2021/10/31 15:00:00+00,Female,934,2150573,697,1979440,24,137816
455,2021/11/01 15:00:00+00,Female,2481,2153054,1806,1981246,139,137955
456,2021/11/02 15:00:00+00,Female,2180,2155234,1576,1982822,139,138094
457,2021/11/03 15:00:00+00,Female,2380,2157614,1554,1984376,160,138254
458,2021/11/04 15:00:00+00,Female,3144,2160758,1689,1986065,117,138371
459,2021/11/05 15:00:00+00,Female,4258,2165016,1967,1988032,141,138512
460,2021/11/06 15:00:00+00,Female,5139,2170155,897,1988929,46,138558
461,2021/11/07 15:00:00+00,Female,3806,2173961,705,1989634,28,138586
462,2021/11/08 15:00:00+00,Female,5707,2179668,1620,1991254,126,138712
463,2021/11/09 15:00:00+00,Female,5990,2185658,1381,1992635,93,138805
464,2021/11/10 15:00:00+00,Female,6401,2192059,1359,1993994,123,138928
465,2021/11/11 15:00:00+00,Female,5803,2197862,1277,1995271,108,139036
466,2021/11/12 15:00:00+00,Female,6145,2204007,1593,1996864,106,139142
467,2021/11/13 15:00:00+00,Female,4907,2208914,795,1997659,50,139192
468,2021/11/14 15:00:00+00,Female,2112,2211026,527,1998186,25,139217
469,2021/11/15 15:00:00+00,Female,4434,2215460,1312,1999498,86,139303
470,2021/11/16 15:00:00+00,Female,4799,2220259,1324,2000822,90,139393
471,2021/11/17 15:00:00+00,Female,4729,2224988,1435,2002257,104,139497
472,2021/11/18 15:00:00+00,Female,4722,2229710,1302,2003559,108,139605
473,2021/11/19 15:00:00+00,Female,4998,2234708,1404,2004963,148,139753
474,2021/11/20 15:00:00+00,Female,5017,2239725,749,2005712,62,139815
475,2021/11/21 15:00:00+00,Female,2143,2241868,559,2006271,43,139858
476,2021/11/22 15:00:00+00,Female,4912,2246780,1277,2007548,108,139966
477,2021/11/23 15:00:00+00,Female,4729,2251509,1178,2008726,85,140051
478,2021/11/24 15:00:00+00,Female,4133,2255642,1265,2009991,92,140143
479,2021/11/25 15:00:00+00,Female,117,2255759,47,2010038,6,140149
480,2021/11/26 15:00:00+00,Female,2846,2258605,1965,2012003,58,140207
481,2021/11/27 15:00:00+00,Female,1945,2260550,2798,2014801,53,140260
482,2021/11/28 15:00:00+00,Female,1228,2261778,3167,2017968,36,140296
483,2021/11/29 15:00:00+00,Female,2837,2264615,4530,2022498,72,140368
484,2021/11/30 15:00:00+00,Female,3212,2267827,4706,2027204,122,140490
485,2021/10/15 15:00:00+00,Federal Entities,371,127812,606,110830,23,16001
486,2021/10/16 15:00:00+00,Federal Entities,206,128018,253,111083,156,16157
487,2021/10/17 15:00:00+00,Federal Entities,278,128296,290,111373,12,16169
488,2021/10/18 15:00:00+00,Federal Entities,75,128371,88,111461,,16169
489,2021/10/19 15:00:00+00,Federal Entities,941,129312,972,112433,5,16174
490,2021/10/20 15:00:00+00,Federal Entities,246,129558,248,112681,13,16187
491,2021/10/22 15:00:00+00,Federal Entities,247,129805,408,113089,194,16381
492,2021/10/23 15:00:00+00,Federal Entities,154,129959,168,113257,188,16569
493,2021/10/24 15:00:00+00,Federal Entities,184,130143,210,113467,11,16580
494,2021/10/25 15:00:00+00,Federal Entities,8,130151,11,113478,,16580
495,2021/10/26 15:00:00+00,Federal Entities,4,130155,10,113488,,16580
496,2021/10/27 15:00:00+00,Federal Entities,182,130337,196,113684,5,16585
497,2021/10/28 15:00:00+00,Federal Entities,150,130487,187,113871,168,16753
498,2021/10/29 15:00:00+00,Federal Entities,314,130801,382,114253,14,16767
499,2021/10/30 15:00:00+00,Federal Entities,20,130821,17,114270,159,16926
500,2021/10/31 15:00:00+00,Federal Entities,141,130962,201,114471,17,16943
501,2021/11/01 15:00:00+00,Federal Entities,147,131109,185,114656,2,16945
502,2021/11/02 15:00:00+00,Federal Entities,4,131113,11,114667,2,16947
503,2021/11/03 15:00:00+00,Federal Entities,88,131201,88,114755,1,16948
504,2021/11/04 15:00:00+00,Federal Entities,169,131370,201,114956,165,17113
505,2021/11/05 15:00:00+00,Federal Entities,103,131473,170,115126,18,17131
506,2021/11/06 15:00:00+00,Federal Entities,138,131611,170,115296,145,17276
507,2021/11/07 15:00:00+00,Federal Entities,85,131696,136,115432,7,17283
508,2021/11/08 15:00:00+00,Federal Entities,12,131708,59,115491,,17283
509,2021/11/09 15:00:00+00,Federal Entities,28,131736,40,115531,3,17286
510,2021/11/10 15:00:00+00,Federal Entities,3,131739,206,115737,8,17294
511,2021/11/12 15:00:00+00,Federal Entities,422,132161,358,116095,234,17528
512,2021/11/13 15:00:00+00,Federal Entities,108,132269,5,116100,195,17723
513,2021/11/14 15:00:00+00,Federal Entities,82,132351,57,116157,51,17774
514,2021/11/15 15:00:00+00,Federal Entities,2,132353,2,116159,,17774
515,2021/11/16 15:00:00+00,Federal Entities,,132353,1,116160,2,17776
516,2021/11/17 15:00:00+00,Federal Entities,148,132501,170,116330,5,17781
517,2021/11/18 15:00:00+00,Federal Entities,179,132680,130,116460,186,17967
518,2021/11/19 15:00:00+00,Federal Entities,217,132897,154,116614,24,17991
519,2021/11/20 15:00:00+00,Federal Entities,432,133329,128,116742,282,18273
520,2021/11/21 15:00:00+00,Federal Entities,204,133533,152,116894,13,18286
521,2021/11/22 15:00:00+00,Federal Entities,59,133592,3,116897,1,18287
522,2021/11/23 15:00:00+00,Federal Entities,4,133596,4,116901,44,18331
523,2021/11/26 15:00:00+00,Federal Entities,250,133846,222,117123,10,18341
524,2021/11/29 15:00:00+00,Federal Entities,688,134534,331,117454,186,18527
525,2021/12/01 15:00:00+00,Federal Entities,267,134801,224,117678,7,18534
526,2021/12/02 15:00:00+00,Federal Entities,270,135071,205,117883,195,18729
527,2021/12/04 15:00:00+00,Federal Entities,603,135674,461,118344,307,19036
528,2021/12/05 15:00:00+00,Federal Entities,334,136008,241,118585,8,19044
529,2021/12/06 15:00:00+00,Federal Entities,4,136012,11,118596,19,19063
530,2021/12/08 15:00:00+00,Federal Entities,276,136288,289,118885,8,19071
531,2021/12/09 15:00:00+00,Federal Entities,220,136508,185,119070,190,19261
532,2021/12/10 15:00:00+00,Federal Entities,276,136784,244,119314,17,19278
533,2021/12/11 15:00:00+00,Federal Entities,216,137000,129,119443,231,19509
534,2021/12/13 15:00:00+00,Federal Entities,2,137002,,119443,5,19514
535,2021/12/14 15:00:00+00,Federal Entities,232,137234,127,119570,7,19521
536,2021/12/15 15:00:00+00,Federal Entities,355,137589,419,119989,13,19534
537,2021/12/16 15:00:00+00,Federal Entities,161,137750,147,120136,170,19704
538,2021/12/17 15:00:00+00,Federal Entities,391,138141,244,120380,11,19715
539,2021/12/18 15:00:00+00,Federal Entities,226,138367,95,120475,229,19944
540,2021/12/19 15:00:00+00,Federal Entities,38,138405,1,120476,2,19946
541,2021/12/21 15:00:00+00,Federal Entities,468,138873,245,120721,9,19955
542,2021/12/22 15:00:00+00,Federal Entities,,138873,,120721,1,19956
543,2021/12/23 15:00:00+00,Federal Entities,538,139411,371,121092,200,20156
544,2021/12/26 15:00:00+00,Federal Entities,381,139792,229,121321,5,20161
545,2021/12/27 15:00:00+00,Federal Entities,223,140015,129,121450,163,20324
546,2021/12/28 15:00:00+00,Federal Entities,1,140016,1,121451,1,20325
547,2021/12/29 15:00:00+00,Federal Entities,54,140070,33,121484,1,20326
548,2021/12/30 15:00:00+00,Federal Entities,250,140320,150,121634,138,20464
549,2022/01/02 15:00:00+00,Federal Entities,307,140627,197,121831,12,20476
550,2021/12/01 15:00:00+00,Female,3499,2271326,4805,2032009,107,140597
551,2021/12/02 15:00:00+00,Female,3517,2274843,4392,2036401,113,140710
552,2021/12/03 15:00:00+00,Female,3926,2278769,4659,2041060,119,140829
553,2021/12/04 15:00:00+00,Female,2741,2281510,4804,2045864,71,140900
554,2021/12/05 15:00:00+00,Female,1579,2283089,1673,2047537,35,140935
555,2021/12/06 15:00:00+00,Female,3412,2286501,3597,2051134,98,141033
556,2021/12/07 15:00:00+00,Female,3314,2289815,3602,2054736,112,141145
557,2021/12/08 15:00:00+00,Female,3374,2293189,3636,2058372,105,141250
558,2021/12/09 15:00:00+00,Female,3216,2296405,3455,2061827,85,141335
559,2021/12/10 15:00:00+00,Female,3677,2300082,3551,2065378,77,141412
560,2021/12/11 15:00:00+00,Female,2116,2302198,3673,2069051,43,141455
561,2021/12/12 15:00:00+00,Female,2018,2304216,1436,2070487,17,141472
562,2021/12/13 15:00:00+00,Female,2929,2307145,2947,2073434,89,141561
563,2021/12/14 15:00:00+00,Female,3222,2310367,3013,2076447,76,141637
564,2021/12/15 15:00:00+00,Female,3460,2313827,2772,2079219,99,141736
565,2021/12/16 15:00:00+00,Female,3930,2317757,1372,2080591,105,141841
566,2021/12/17 15:00:00+00,Female,3846,2321603,2009,2082600,68,141909
567,2021/12/18 15:00:00+00,Female,2818,2324421,1541,2084141,30,141939
568,2021/12/19 15:00:00+00,Female,1670,2326091,703,2084844,16,141955
569,2021/12/20 15:00:00+00,Female,4181,2330272,1895,2086739,81,142036
570,2021/12/21 15:00:00+00,Female,4386,2334658,2058,2088797,54,142090
571,2021/12/22 15:00:00+00,Female,4375,2339033,2021,2090818,70,142160
572,2021/12/23 15:00:00+00,Female,3946,2342979,1664,2092482,45,142205
573,2021/12/24 15:00:00+00,Female,774,2343753,485,2092967,16,142221
574,2021/12/25 15:00:00+00,Female,20,2343773,21,2092988,1,142222
575,2021/12/26 15:00:00+00,Female,1105,2344878,772,2093760,16,142238
576,2021/12/27 15:00:00+00,Female,3656,2348534,1969,2095729,49,142287
577,2021/12/28 15:00:00+00,Female,4062,2352596,1980,2097709,62,142349
578,2021/12/29 15:00:00+00,Female,4212,2356808,2022,2099731,55,142404
579,2021/12/30 15:00:00+00,Female,3579,2360387,1855,2101586,55,142459
580,2021/12/31 15:00:00+00,Female,1302,2361689,804,2102390,30,142489
581,2022/01/01 15:00:00+00,Female,385,2362074,190,2102580,16,142505
582,2022/01/02 15:00:00+00,Female,928,2363002,739,2103319,11,142516
583,2022/01/03 15:00:00+00,Female,1639,2364641,998,2104317,23,142539
584,2022/01/04 15:00:00+00,Female,2870,2367511,1785,2106102,56,142595
585,2022/01/05 15:00:00+00,Female,3415,2370926,2374,2108476,67,142662
586,2022/01/06 15:00:00+00,Female,3418,2374344,2470,2110946,63,142725
587,2022/01/07 15:00:00+00,Female,2942,2377286,1897,2112843,56,142781
588,2022/01/08 15:00:00+00,Female,2267,2379553,1910,2114753,28,142809
589,2022/01/09 15:00:00+00,Female,1303,2380856,953,2115706,16,142825
590,2022/01/10 15:00:00+00,Female,3233,2384089,1960,2117666,59,142884
591,2022/01/11 15:00:00+00,Female,3327,2387416,2175,2119841,58,142942
592,2022/01/12 15:00:00+00,Female,3379,2390795,2179,2122020,58,143000
593,2022/01/13 15:00:00+00,Female,3324,2394119,2235,2124255,56,143056
594,2022/01/14 15:00:00+00,Female,3657,2397776,1662,2125917,57,143113
595,2022/01/15 15:00:00+00,Female,2039,2399815,811,2126728,23,143136
596,2022/01/16 15:00:00+00,Female,1008,2400823,599,2127327,13,143149
597,2022/01/17 15:00:00+00,Female,1831,2402654,1234,2128561,32,143181
598,2022/01/18 15:00:00+00,Female,2544,2405198,2046,2130607,32,143213
599,2022/01/19 15:00:00+00,Female,2658,2407856,2273,2132880,38,143251
600,2022/01/20 15:00:00+00,Female,2286,2410142,1838,2134718,40,143291
601,2022/01/21 15:00:00+00,Female,2801,2412943,1463,2136181,44,143335
602,2022/01/22 15:00:00+00,Female,1706,2414649,851,2137032,18,143353
603,2022/01/23 15:00:00+00,Female,904,2415553,696,2137728,11,143364
604,2022/01/24 15:00:00+00,Female,2172,2417725,1441,2139169,31,143395
605,2022/01/25 15:00:00+00,Female,1942,2419667,1661,2140830,49,143444
606,2022/01/26 15:00:00+00,Female,2063,2421730,1883,2142713,43,143487
607,2022/01/27 15:00:00+00,Female,1920,2423650,1920,2144633,36,143523
608,2022/01/28 15:00:00+00,Female,1952,2425602,1640,2146273,28,143551
609,2022/01/29 15:00:00+00,Female,1082,2426684,1100,2147373,13,143564
610,2022/01/30 15:00:00+00,Female,709,2427393,760,2148133,6,143570
611,2022/01/31 15:00:00+00,Female,1549,2428942,1658,2149791,25,143595
612,2022/02/01 15:00:00+00,Female,1377,2430319,1717,2151508,33,143628
613,2022/02/02 15:00:00+00,Female,1441,2431760,1855,2153363,30,143658
614,2022/02/03 15:00:00+00,Female,1419,2433179,1880,2155243,15,143673
615,2022/02/04 15:00:00+00,Female,1373,2434552,2177,2157420,22,143695
616,2022/02/05 15:00:00+00,Female,939,2435491,1378,2158798,19,143714
617,2022/02/06 15:00:00+00,Female,516,2436007,629,2159427,9,143723
618,2022/02/07 15:00:00+00,Female,1091,2437098,1347,2160774,16,143739
619,2022/02/08 15:00:00+00,Female,1069,2438167,1614,2162388,18,143757
620,2022/02/09 15:00:00+00,Female,1125,2439292,1680,2164068,31,143788
621,2022/02/10 15:00:00+00,Female,1046,2440338,1434,2165502,17,143805
622,2022/02/11 15:00:00+00,Female,1265,2441603,1809,2167311,27,143832
623,2022/02/12 15:00:00+00,Female,787,2442390,1061,2168372,15,143847
624,2022/02/13 15:00:00+00,Female,351,2442741,522,2168894,7,143854
625,2022/02/14 15:00:00+00,Female,730,2443471,1158,2170052,32,143886
626,2022/02/15 15:00:00+00,Female,929,2444400,1255,2171307,21,143907
627,2022/02/16 15:00:00+00,Female,848,2445248,1271,2172578,21,143928
628,2022/02/17 15:00:00+00,Female,825,2446073,1171,2173749,12,143940
629,2022/02/18 15:00:00+00,Female,1105,2447178,1405,2175154,15,143955
630,2022/02/19 15:00:00+00,Female,602,2447780,786,2175940,5,143960
631,2022/02/20 15:00:00+00,Female,384,2448164,432,2176372,7,143967
632,2022/02/21 15:00:00+00,Female,684,2448848,947,2177319,15,143982
633,2022/02/22 15:00:00+00,Female,767,2449615,1039,2178358,18,144000
634,2022/02/23 15:00:00+00,Female,780,2450395,976,2179334,13,144013
635,2022/02/24 15:00:00+00,Female,800,2451195,916,2180250,8,144021
636,2022/02/25 15:00:00+00,Female,906,2452101,1008,2181258,28,144049
637,2022/02/26 15:00:00+00,Female,647,2452748,589,2181847,9,144058
638,2022/02/27 15:00:00+00,Female,344,2453092,276,2182123,4,144062
639,2022/02/28 15:00:00+00,Female,741,2453833,774,2182897,14,144076
640,2022/03/01 15:00:00+00,Female,783,2454616,712,2183609,14,144090
641,2022/03/02 15:00:00+00,Female,626,2455242,707,2184316,18,144108
642,2022/03/03 15:00:00+00,Female,662,2455904,693,2185009,11,144119
643,2022/03/04 15:00:00+00,Female,766,2456670,766,2185775,11,144130
644,2022/03/05 15:00:00+00,Female,441,2457111,467,2186242,6,144136
645,2022/03/06 15:00:00+00,Female,218,2457329,243,2186485,6,144142
646,2022/03/07 15:00:00+00,Female,472,2457801,430,2186915,8,144150
647,2022/03/08 15:00:00+00,Female,545,2458346,531,2187446,9,144159
648,2022/03/09 15:00:00+00,Female,506,2458852,548,2187994,9,144168
649,2022/03/10 15:00:00+00,Female,509,2459361,527,2188521,9,144177
650,2022/03/11 15:00:00+00,Female,600,2459961,748,2189269,5,144182
651,2022/03/12 15:00:00+00,Female,230,2460191,284,2189553,3,144185
652,2022/03/13 15:00:00+00,Female,193,2460384,230,2189783,2,144187
653,2022/03/14 15:00:00+00,Female,420,2460804,386,2190169,11,144198
654,2022/03/15 15:00:00+00,Female,416,2461220,474,2190643,6,144204
655,2022/03/16 15:00:00+00,Female,509,2461729,523,2191166,15,144219
656,2022/03/17 15:00:00+00,Female,409,2462138,408,2191574,7,144226
657,2022/03/18 15:00:00+00,Female,529,2462667,555,2192129,12,144238
658,2022/03/19 15:00:00+00,Female,261,2462928,314,2192443,6,144244
659,2022/03/20 15:00:00+00,Female,163,2463091,173,2192616,1,144245
660,2022/03/21 15:00:00+00,Female,190,2463281,168,2192784,6,144251
661,2020/12/14 15:00:00+00,Male,4,4,,0,,0
662,2020/12/15 15:00:00+00,Male,20,24,1,1,,0
663,2020/12/16 15:00:00+00,Male,249,273,1,2,,0
664,2020/12/17 15:00:00+00,Male,388,661,,2,,0
665,2020/12/18 15:00:00+00,Male,987,1648,2,4,,0
666,2020/12/19 15:00:00+00,Male,331,1979,1,5,,0
667,2020/12/20 15:00:00+00,Male,122,2101,3,8,,0
668,2020/12/21 15:00:00+00,Male,1324,3425,5,13,,0
669,2020/12/22 15:00:00+00,Male,2084,5509,6,19,,0
670,2020/12/23 15:00:00+00,Male,1785,7294,14,33,,0
671,2020/12/24 15:00:00+00,Male,927,8221,4,37,,0
672,2020/12/25 15:00:00+00,Male,307,8528,,37,,0
673,2020/12/26 15:00:00+00,Male,620,9148,2,39,,0
674,2020/12/27 15:00:00+00,Male,534,9682,3,42,,0
675,2020/12/28 15:00:00+00,Male,2683,12365,12,54,,0
676,2020/12/29 15:00:00+00,Male,3468,15833,8,62,,0
677,2020/12/30 15:00:00+00,Male,4087,19920,17,79,,0
678,2020/12/31 15:00:00+00,Male,2667,22587,14,93,,0
679,2021/01/01 15:00:00+00,Male,1023,23610,29,122,,0
680,2021/01/02 15:00:00+00,Male,938,24548,18,140,,0
681,2021/01/03 15:00:00+00,Male,1041,25589,39,179,,0
682,2021/01/04 15:00:00+00,Male,4437,30026,112,291,,0
683,2021/01/05 15:00:00+00,Male,4123,34149,165,456,,0
684,2021/01/06 15:00:00+00,Male,5254,39403,326,782,,0
685,2021/01/07 15:00:00+00,Male,4904,44307,620,1402,,0
686,2021/01/08 15:00:00+00,Male,5078,49385,898,2300,,0
687,2021/01/09 15:00:00+00,Male,1750,51135,300,2600,,0
688,2021/01/10 15:00:00+00,Male,1076,52211,123,2723,,0
689,2021/01/11 15:00:00+00,Male,4946,57157,1190,3913,,0
690,2021/01/12 15:00:00+00,Male,6599,63756,1796,5709,,0
691,2021/01/13 15:00:00+00,Male,6707,70463,1165,6874,,0
692,2022/01/03 15:00:00+00,Federal Entities,17,140644,7,121838,146,20622
693,2022/01/04 15:00:00+00,Federal Entities,58,140702,27,121865,16,20638
694,2022/01/06 15:00:00+00,Federal Entities,60,140762,63,121928,99,20737
695,2022/01/07 15:00:00+00,Federal Entities,164,140926,120,122048,8,20745
696,2022/01/09 15:00:00+00,Federal Entities,117,141043,59,122107,113,20858
697,2022/01/10 15:00:00+00,Federal Entities,35,141078,27,122134,1,20859
698,2022/01/11 15:00:00+00,Federal Entities,1,141079,1,122135,,20859
699,2022/01/12 15:00:00+00,Federal Entities,16,141095,9,122144,51,20910
700,2022/01/13 15:00:00+00,Federal Entities,167,141262,181,122325,6,20916
701,2022/01/14 15:00:00+00,Federal Entities,85,141347,66,122391,111,21027
702,2022/01/15 15:00:00+00,Federal Entities,99,141446,64,122455,11,21038
703,2022/01/16 15:00:00+00,Federal Entities,198,141644,171,122626,94,21132
704,2022/01/18 15:00:00+00,Federal Entities,321,141965,216,122842,8,21140
705,2022/01/19 15:00:00+00,Federal Entities,,141965,3,122845,1,21141
706,2022/01/20 15:00:00+00,Federal Entities,24,141989,34,122879,87,21228
707,2022/01/21 15:00:00+00,Federal Entities,161,142150,166,123045,3,21231
708,2022/01/22 15:00:00+00,Federal Entities,52,142202,41,123086,63,21294
709,2022/01/23 15:00:00+00,Federal Entities,137,142339,117,123203,1,21295
710,2022/01/26 15:00:00+00,Federal Entities,4,142343,2,123205,,21295
711,2022/01/27 15:00:00+00,Federal Entities,107,142450,83,123288,110,21405
712,2022/01/28 15:00:00+00,Federal Entities,115,142565,78,123366,8,21413
713,2022/01/29 15:00:00+00,Federal Entities,47,142612,41,123407,84,21497
714,2022/01/30 15:00:00+00,Federal Entities,83,142695,93,123500,1,21498
715,2022/02/01 15:00:00+00,Federal Entities,6,142701,6,123506,,21498
716,2022/02/02 15:00:00+00,Federal Entities,32,142733,34,123540,4,21502
717,2022/02/04 15:00:00+00,Federal Entities,89,142822,64,123604,71,21573
718,2022/02/05 15:00:00+00,Federal Entities,78,142900,84,123688,69,21642
719,2022/02/06 15:00:00+00,Federal Entities,69,142969,99,123787,3,21645
720,2022/02/08 15:00:00+00,Federal Entities,1,142970,1,123788,1,21646
721,2022/02/09 15:00:00+00,Federal Entities,6,142976,8,123796,1,21647
722,2022/02/10 15:00:00+00,Federal Entities,17,142993,14,123810,1,21648
723,2022/02/11 15:00:00+00,Federal Entities,52,143045,43,123853,61,21709
724,2022/02/12 15:00:00+00,Federal Entities,131,143176,112,123965,66,21775
725,2022/02/13 15:00:00+00,Federal Entities,56,143232,61,124026,2,21777
726,2022/02/14 15:00:00+00,Federal Entities,,143232,1,124027,,21777
727,2022/02/16 15:00:00+00,Federal Entities,9,143241,10,124037,2,21779
728,2022/02/17 15:00:00+00,Federal Entities,15236,158477,10791,134828,447,22226
729,2022/02/18 15:00:00+00,Federal Entities,25,158502,27,134855,1,22227
730,2022/02/19 15:00:00+00,Federal Entities,60,158562,54,134909,26,22253
731,2022/02/23 15:00:00+00,Federal Entities,72,158634,52,134961,5,22258
732,2022/02/24 15:00:00+00,Federal Entities,1,158635,,134961,,22258
733,2022/02/25 15:00:00+00,Federal Entities,14,158649,22,134983,26,22284
734,2022/02/26 15:00:00+00,Federal Entities,65,158714,61,135044,28,22312
735,2022/03/01 15:00:00+00,Federal Entities,43,158757,64,135108,4,22316
736,2022/03/02 15:00:00+00,Federal Entities,6,158763,5,135113,28,22344
737,2022/03/03 15:00:00+00,Federal Entities,27,158790,25,135138,2,22346
738,2022/03/04 15:00:00+00,Federal Entities,60,158850,49,135187,14,22360
739,2022/03/05 15:00:00+00,Federal Entities,21,158871,23,135210,5,22365
740,2022/03/06 15:00:00+00,Federal Entities,29,158900,43,135253,2,22367
741,2022/03/07 15:00:00+00,Federal Entities,1,158901,3,135256,,22367
742,2022/03/09 15:00:00+00,Federal Entities,20,158921,21,135277,3,22370
743,2022/03/11 15:00:00+00,Federal Entities,60,158981,51,135328,34,22404
744,2022/03/12 15:00:00+00,Federal Entities,27,159008,24,135352,4,22408
745,2022/03/13 15:00:00+00,Federal Entities,40,159048,44,135396,3,22411
746,2022/03/16 15:00:00+00,Federal Entities,29,159077,28,135424,,22411
747,2022/03/17 15:00:00+00,Federal Entities,14,159091,17,135441,7,22418
748,2022/03/18 15:00:00+00,Federal Entities,25,159116,15,135456,8,22426
749,2022/03/19 15:00:00+00,Federal Entities,24,159140,21,135477,3,22429
750,2022/03/20 15:00:00+00,Federal Entities,37,159177,31,135508,3,22432
751,2022/03/21 15:00:00+00,Federal Entities,1,159178,1,135509,,22432
752,2020/12/15 15:00:00+00,Unknown,1,1,,0,,0
753,2020/12/17 15:00:00+00,Unknown,1,2,,0,,0
754,2020/12/18 15:00:00+00,Unknown,22,24,,0,,0
755,2020/12/19 15:00:00+00,Unknown,1,25,,0,,0
756,2020/12/21 15:00:00+00,Unknown,23,48,,0,,0
757,2020/12/22 15:00:00+00,Unknown,4,52,,0,,0
758,2021/01/14 15:00:00+00,Male,6289,76752,652,7526,,0
759,2021/01/15 15:00:00+00,Male,6199,82951,610,8136,,0
760,2021/01/16 15:00:00+00,Male,1912,84863,551,8687,,0
761,2021/01/17 15:00:00+00,Male,643,85506,445,9132,,0
762,2021/01/18 15:00:00+00,Male,2562,88068,944,10076,,0
763,2021/01/19 15:00:00+00,Male,6544,94612,1560,11636,,0
764,2021/01/20 15:00:00+00,Male,8214,102826,1508,13144,,0
765,2021/01/21 15:00:00+00,Male,9075,111901,1173,14317,,0
766,2021/01/22 15:00:00+00,Male,10546,122447,1218,15535,,0
767,2021/01/23 15:00:00+00,Male,3549,125996,611,16146,,0
768,2021/01/24 15:00:00+00,Male,1273,127269,494,16640,,0
769,2021/01/25 15:00:00+00,Male,6209,133478,2655,19295,,0
770,2021/01/26 15:00:00+00,Male,6797,140275,3111,22406,,0
771,2021/01/27 15:00:00+00,Male,9452,149727,4177,26583,,0
772,2021/01/28 15:00:00+00,Male,8801,158528,3065,29648,,0
773,2021/01/29 15:00:00+00,Male,9475,168003,2383,32031,,0
774,2021/01/30 15:00:00+00,Male,6681,174684,772,32803,,0
775,2021/01/31 15:00:00+00,Male,1499,176183,526,33329,,0
776,2021/02/01 15:00:00+00,Male,3074,179257,1887,35216,,0
777,2021/02/02 15:00:00+00,Male,5158,184415,4914,40130,,0
778,2021/02/03 15:00:00+00,Male,7284,191699,6646,46776,,0
779,2021/02/04 15:00:00+00,Male,8802,200501,5391,52167,,0
780,2021/02/05 15:00:00+00,Male,7828,208329,5346,57513,,0
781,2021/02/06 15:00:00+00,Male,4139,212468,2129,59642,,0
782,2021/02/07 15:00:00+00,Male,2307,214775,608,60250,,0
783,2021/02/08 15:00:00+00,Male,5068,219843,4615,64865,,0
784,2021/02/09 15:00:00+00,Male,6640,226483,5157,70022,,0
785,2021/02/10 15:00:00+00,Male,7542,234025,7796,77818,,0
786,2021/02/11 15:00:00+00,Male,9067,243092,6785,84603,,0
787,2021/02/12 15:00:00+00,Male,7793,250885,6911,91514,,0
788,2021/02/13 15:00:00+00,Male,4740,255625,2371,93885,,0
789,2021/02/14 15:00:00+00,Male,2834,258459,842,94727,,0
790,2021/02/15 15:00:00+00,Male,4845,263304,4641,99368,,0
791,2021/02/16 15:00:00+00,Male,6867,270171,7998,107366,,0
792,2021/02/17 15:00:00+00,Male,7855,278026,9879,117245,,0
793,2021/02/18 15:00:00+00,Male,1456,279482,1831,119076,,0
794,2021/02/19 15:00:00+00,Male,4371,283853,7506,126582,,0
795,2021/02/20 15:00:00+00,Male,4209,288062,7200,133782,,0
796,2021/02/21 15:00:00+00,Male,2585,290647,2974,136756,,0
797,2021/02/22 15:00:00+00,Male,3471,294118,5922,142678,,0
798,2021/02/23 15:00:00+00,Male,6398,300516,6141,148819,,0
799,2021/02/24 15:00:00+00,Male,7431,307947,9839,158658,,0
800,2021/02/25 15:00:00+00,Male,8435,316382,10390,169048,,0
801,2021/02/26 15:00:00+00,Male,10988,327370,9939,178987,,0
802,2021/02/27 15:00:00+00,Male,6534,333904,4118,183105,,0
803,2021/02/28 15:00:00+00,Male,6378,340282,1826,184931,,0
804,2021/03/01 15:00:00+00,Male,11445,351727,4907,189838,,0
805,2021/03/02 15:00:00+00,Male,10230,361957,5374,195212,21,21
806,2021/03/03 15:00:00+00,Male,13050,375007,7226,202438,101,122
807,2021/03/04 15:00:00+00,Male,13450,388457,7215,209653,1791,1913
808,2021/03/05 15:00:00+00,Male,12804,401261,7437,217090,2238,4151
809,2021/03/06 15:00:00+00,Male,8125,409386,3621,220711,2712,6863
810,2021/03/07 15:00:00+00,Male,5391,414777,2054,222765,2853,9716
811,2021/03/08 15:00:00+00,Male,11655,426432,3799,226564,3793,13509
812,2021/03/09 15:00:00+00,Male,11483,437915,6512,233076,3994,17503
813,2021/03/10 15:00:00+00,Male,13113,451028,6294,239370,3738,21241
814,2021/03/11 15:00:00+00,Male,16292,467320,6464,245834,1684,22925
815,2021/03/12 15:00:00+00,Male,16321,483641,7283,253117,1257,24182
816,2021/03/13 15:00:00+00,Male,10109,493750,4302,257419,765,24947
817,2021/03/14 15:00:00+00,Male,8233,501983,2755,260174,473,25420
818,2021/03/15 15:00:00+00,Male,13556,515539,4753,264927,261,25681
819,2021/03/16 15:00:00+00,Male,15410,530949,5600,270527,379,26060
820,2021/03/17 15:00:00+00,Male,16970,547919,6823,277350,569,26629
821,2021/03/18 15:00:00+00,Male,19012,566931,5286,282636,607,27236
822,2021/03/19 15:00:00+00,Male,17405,584336,6452,289088,466,27702
823,2021/03/20 15:00:00+00,Male,11260,595596,4133,293221,345,28047
824,2021/03/21 15:00:00+00,Male,9014,604610,3277,296498,172,28219
825,2021/03/22 15:00:00+00,Male,14956,619566,5011,301509,371,28590
826,2021/03/23 15:00:00+00,Male,18062,637628,7478,308987,695,29285
827,2021/03/24 15:00:00+00,Male,19203,656831,8771,317758,615,29900
828,2021/03/25 15:00:00+00,Male,20026,676857,8989,326747,1147,31047
829,2021/03/26 15:00:00+00,Male,16911,693768,11041,337788,1125,32172
830,2021/03/27 15:00:00+00,Male,12460,706228,7305,345093,1179,33351
831,2021/03/28 15:00:00+00,Male,8013,714241,5551,350644,787,34138
832,2021/03/29 15:00:00+00,Male,14004,728245,11408,362052,518,34656
833,2021/03/30 15:00:00+00,Male,19173,747418,12294,374346,837,35493
834,2021/03/31 15:00:00+00,Male,19478,766896,15136,389482,2662,38155
835,2021/04/01 15:00:00+00,Male,19811,786707,18546,408028,2725,40880
836,2021/04/02 15:00:00+00,Male,16520,803227,14202,422230,2948,43828
837,2021/04/03 15:00:00+00,Male,9968,813195,8530,430760,2043,45871
838,2021/04/04 15:00:00+00,Male,3917,817112,4662,435422,496,46367
839,2021/04/05 15:00:00+00,Male,12990,830102,13039,448461,3253,49620
840,2021/04/06 15:00:00+00,Male,19076,849178,13813,462274,5092,54712
841,2021/04/07 15:00:00+00,Male,17311,866489,15345,477619,6315,61027
842,2021/04/08 15:00:00+00,Male,20326,886815,16046,493665,6994,68021
843,2021/04/09 15:00:00+00,Male,15905,902720,16230,509895,7175,75196
844,2021/04/10 15:00:00+00,Male,11227,913947,10323,520218,3771,78967
845,2021/04/11 15:00:00+00,Male,8478,922425,6105,526323,5272,84239
846,2021/04/12 15:00:00+00,Male,12030,934455,15254,541577,5526,89765
847,2021/04/13 15:00:00+00,Male,20406,954861,17177,558754,179,89944
848,2021/04/14 15:00:00+00,Male,19698,974559,17435,576189,106,90050
849,2021/04/15 15:00:00+00,Male,20184,994743,17823,594012,76,90126
850,2021/04/16 15:00:00+00,Male,17622,1012365,17167,611179,6,90132
851,2021/04/17 15:00:00+00,Male,15372,1027737,9789,620968,4,90136
852,2021/04/18 15:00:00+00,Male,9807,1037544,7778,628746,2,90138
853,2021/04/19 15:00:00+00,Male,14160,1051704,16270,645016,21,90159
854,2021/04/20 15:00:00+00,Male,14960,1066664,19895,664911,24,90183
855,2021/04/21 15:00:00+00,Male,19599,1086263,21693,686604,16,90199
856,2021/04/22 15:00:00+00,Male,17507,1103770,19898,706502,12,90211
857,2021/04/23 15:00:00+00,Male,16285,1120055,18212,724714,8,90219
858,2021/04/24 15:00:00+00,Male,13479,1133534,13136,737850,60,90279
859,2021/04/25 15:00:00+00,Male,9865,1143399,3934,741784,12,90291
860,2021/04/26 15:00:00+00,Male,13192,1156591,14695,756479,98,90389
861,2021/04/27 15:00:00+00,Male,13319,1169910,15822,772301,684,91073
862,2021/04/28 15:00:00+00,Male,14465,1184375,19079,791380,851,91924
863,2021/04/29 15:00:00+00,Male,13449,1197824,18604,809984,893,92817
864,2021/04/30 15:00:00+00,Male,13858,1211682,14990,824974,1007,93824
865,2021/05/01 15:00:00+00,Male,9468,1221150,11587,836561,670,94494
866,2021/05/02 15:00:00+00,Male,4749,1225899,7311,843872,517,95011
867,2021/05/03 15:00:00+00,Male,6237,1232136,12691,856563,1141,96152
868,2021/05/04 15:00:00+00,Male,6666,1238802,18844,875407,1080,97232
869,2021/05/05 15:00:00+00,Male,9506,1248308,18149,893556,1186,98418
870,2021/05/06 15:00:00+00,Male,8375,1256683,19215,912771,1049,99467
871,2021/05/07 15:00:00+00,Male,8668,1265351,17374,930145,1171,100638
872,2021/05/08 15:00:00+00,Male,5379,1270730,14586,944731,831,101469
873,2021/05/09 15:00:00+00,Male,2603,1273333,6195,950926,455,101924
874,2021/05/10 15:00:00+00,Male,4332,1277665,14380,965306,848,102772
875,2021/05/11 15:00:00+00,Male,6077,1283742,14972,980278,888,103660
876,2021/05/12 15:00:00+00,Male,6460,1290202,18437,998715,1186,104846
877,2021/05/13 15:00:00+00,Male,10554,1300756,16565,1015280,814,105660
878,2021/05/14 15:00:00+00,Male,11649,1312405,14327,1029607,1053,106713
879,2021/05/15 15:00:00+00,Male,10577,1322982,11583,1041190,914,107627
880,2021/05/16 15:00:00+00,Male,4559,1327541,8791,1049981,712,108339
881,2021/05/17 15:00:00+00,Male,8091,1335632,12978,1062959,1198,109537
882,2021/05/18 15:00:00+00,Male,10336,1345968,15335,1078294,1203,110740
883,2021/05/19 15:00:00+00,Male,13704,1359672,16375,1094669,1016,111756
884,2021/05/20 15:00:00+00,Male,9781,1369453,16238,1110907,1255,113011
885,2021/05/21 15:00:00+00,Male,9279,1378732,14936,1125843,994,114005
886,2021/05/22 15:00:00+00,Male,7979,1386711,9679,1135522,824,114829
887,2021/05/23 15:00:00+00,Male,4546,1391257,5823,1141345,615,115444
888,2021/05/24 15:00:00+00,Male,6488,1397745,8507,1149852,925,116369
889,2021/05/25 15:00:00+00,Male,6431,1404176,9280,1159132,806,117175
890,2021/05/26 15:00:00+00,Male,9025,1413201,9845,1168977,970,118145
891,2021/05/27 15:00:00+00,Male,5369,1418570,8944,1177921,702,118847
892,2021/05/28 15:00:00+00,Male,5757,1424327,9726,1187647,862,119709
893,2021/05/29 15:00:00+00,Male,4801,1429128,5844,1193491,610,120319
894,2021/05/30 15:00:00+00,Male,2524,1431652,3386,1196877,417,120736
895,2021/05/31 15:00:00+00,Male,787,1432439,1686,1198563,195,120931
896,2021/06/01 15:00:00+00,Male,4679,1437118,8049,1206612,742,121673
897,2021/06/02 15:00:00+00,Male,4847,1441965,8305,1214917,606,122279
898,2021/06/03 15:00:00+00,Male,3827,1445792,10305,1225222,692,122971
899,2021/06/04 15:00:00+00,Male,3783,1449575,10972,1236194,686,123657
900,2021/06/05 15:00:00+00,Male,3445,1453020,9589,1245783,472,124129
901,2021/06/06 15:00:00+00,Male,1711,1454731,3609,1249392,280,124409
902,2021/06/07 15:00:00+00,Male,3314,1458045,7843,1257235,441,124850
903,2021/06/08 15:00:00+00,Male,3134,1461179,9672,1266907,513,125363
904,2020/12/23 15:00:00+00,Unknown,2,54,,0,,0
905,2020/12/24 15:00:00+00,Unknown,3,57,,0,,0
906,2020/12/28 15:00:00+00,Unknown,7,64,,0,,0
907,2020/12/29 15:00:00+00,Unknown,4,68,,0,,0
908,2020/12/30 15:00:00+00,Unknown,7,75,,0,,0
909,2020/12/31 15:00:00+00,Unknown,2,77,,0,,0
910,2021/01/01 15:00:00+00,Unknown,5,82,,0,,0
911,2021/01/02 15:00:00+00,Unknown,2,84,,0,,0
912,2021/01/03 15:00:00+00,Unknown,2,86,,0,,0
913,2021/01/04 15:00:00+00,Unknown,7,93,,0,,0
914,2021/01/05 15:00:00+00,Unknown,9,102,,0,,0
915,2021/01/06 15:00:00+00,Unknown,14,116,2,2,,0
916,2021/01/07 15:00:00+00,Unknown,16,132,3,5,,0
917,2021/01/08 15:00:00+00,Unknown,8008,8140,21,26,,0
918,2021/01/09 15:00:00+00,Unknown,3,8143,1,27,,0
919,2021/01/10 15:00:00+00,Unknown,2,8145,,27,,0
920,2021/01/11 15:00:00+00,Unknown,4,8149,2,29,,0
921,2021/01/12 15:00:00+00,Unknown,8,8157,18,47,,0
922,2021/01/13 15:00:00+00,Unknown,9,8166,1,48,,0
923,2021/01/14 15:00:00+00,Unknown,2,8168,2,50,,0
924,2021/01/15 15:00:00+00,Unknown,22,8190,,50,,0
925,2021/01/16 15:00:00+00,Unknown,5,8195,1,51,,0
926,2021/01/17 15:00:00+00,Unknown,1,8196,,51,,0
927,2021/01/18 15:00:00+00,Unknown,7,8203,,51,,0
928,2021/01/19 15:00:00+00,Unknown,7,8210,1,52,,0
929,2021/01/20 15:00:00+00,Unknown,24,8234,2,54,,0
930,2021/01/21 15:00:00+00,Unknown,82,8316,4,58,,0
931,2021/01/22 15:00:00+00,Unknown,72,8388,1,59,,0
932,2021/01/23 15:00:00+00,Unknown,47,8435,1,60,,0
933,2021/01/24 15:00:00+00,Unknown,17,8452,2,62,,0
934,2021/01/25 15:00:00+00,Unknown,17,8469,4,66,,0
935,2021/01/26 15:00:00+00,Unknown,61,8530,4,70,,0
936,2021/01/27 15:00:00+00,Unknown,16,8546,7,77,,0
937,2021/01/28 15:00:00+00,Unknown,12,8558,7,84,,0
938,2021/01/29 15:00:00+00,Unknown,76,8634,4,88,,0
939,2021/01/30 15:00:00+00,Unknown,8,8642,,88,,0
940,2021/01/31 15:00:00+00,Unknown,3,8645,1,89,,0
941,2021/02/01 15:00:00+00,Unknown,13,8658,12,101,,0
942,2021/02/02 15:00:00+00,Unknown,5,8663,9,110,,0
943,2021/02/03 15:00:00+00,Unknown,64,8727,5,115,,0
944,2021/02/04 15:00:00+00,Unknown,72,8799,6,121,,0
945,2021/02/05 15:00:00+00,Unknown,99,8898,12,133,,0
946,2021/02/06 15:00:00+00,Unknown,26,8924,8001,8134,,0
947,2021/02/07 15:00:00+00,Unknown,1,8925,3,8137,,0
948,2021/02/08 15:00:00+00,Unknown,73,8998,5,8142,,0
949,2021/02/09 15:00:00+00,Unknown,53,9051,10,8152,,0
950,2021/02/10 15:00:00+00,Unknown,42,9093,32,8184,,0
951,2021/02/11 15:00:00+00,Unknown,28,9121,54,8238,,0
952,2021/02/12 15:00:00+00,Unknown,26,9147,39,8277,,0
953,2021/02/13 15:00:00+00,Unknown,3,9150,,8277,,0
954,2021/02/14 15:00:00+00,Unknown,2,9152,,8277,,0
955,2021/02/15 15:00:00+00,Unknown,13,9165,32,8309,,0
956,2021/02/16 15:00:00+00,Unknown,74,9239,54,8363,,0
957,2021/02/17 15:00:00+00,Unknown,86,9325,16,8379,,0
958,2021/02/18 15:00:00+00,Unknown,6,9331,3,8382,,0
959,2021/02/19 15:00:00+00,Unknown,28,9359,10,8392,,0
960,2021/02/20 15:00:00+00,Unknown,52,9411,20,8412,,0
961,2021/02/21 15:00:00+00,Unknown,5,9416,10,8422,,0
962,2021/02/22 15:00:00+00,Unknown,7,9423,8,8430,,0
963,2021/02/23 15:00:00+00,Unknown,65,9488,13,8443,,0
964,2021/02/24 15:00:00+00,Unknown,8,9496,22,8465,,0
965,2021/02/25 15:00:00+00,Unknown,24,9520,45,8510,,0
966,2021/02/26 15:00:00+00,Unknown,21,9541,123,8633,,0
967,2021/02/27 15:00:00+00,Unknown,9,9550,4,8637,,0
968,2021/02/28 15:00:00+00,Unknown,13,9563,1,8638,,0
969,2021/03/01 15:00:00+00,Unknown,52,9615,66,8704,,0
970,2021/03/02 15:00:00+00,Unknown,42,9657,43,8747,,0
971,2021/03/03 15:00:00+00,Unknown,92,9749,13,8760,,0
972,2021/03/04 15:00:00+00,Unknown,47,9796,49,8809,2,2
973,2021/03/05 15:00:00+00,Unknown,64,9860,99,8908,1,3
974,2021/03/06 15:00:00+00,Unknown,15,9875,6,8914,1,4
975,2021/03/07 15:00:00+00,Unknown,7,9882,1,8915,2,6
976,2021/03/08 15:00:00+00,Unknown,110,9992,12,8927,1,7
977,2021/06/09 15:00:00+00,Male,3925,1465104,11680,1278587,605,125968
978,2021/06/10 15:00:00+00,Male,3396,1468500,9316,1287903,549,126517
979,2021/06/11 15:00:00+00,Male,3617,1472117,8362,1296265,691,127208
980,2021/06/12 15:00:00+00,Male,2600,1474717,7376,1303641,391,127599
981,2021/06/13 15:00:00+00,Male,992,1475709,3895,1307536,288,127887
982,2021/06/14 15:00:00+00,Male,2710,1478419,5772,1313308,440,128327
983,2021/06/15 15:00:00+00,Male,2603,1481022,7048,1320356,520,128847
984,2021/06/16 15:00:00+00,Male,3150,1484172,8812,1329168,424,129271
985,2021/06/17 15:00:00+00,Male,3041,1487213,5837,1335005,430,129701
986,2021/06/18 15:00:00+00,Male,2970,1490183,5726,1340731,408,130109
987,2021/06/19 15:00:00+00,Male,2124,1492307,4561,1345292,391,130500
988,2021/06/20 15:00:00+00,Male,1177,1493484,2444,1347736,256,130756
989,2021/06/21 15:00:00+00,Male,2598,1496082,2477,1350213,402,131158
990,2021/06/22 15:00:00+00,Male,2554,1498636,4316,1354529,457,131615
991,2021/06/23 15:00:00+00,Male,2781,1501417,5105,1359634,373,131988
992,2021/06/24 15:00:00+00,Male,2523,1503940,3745,1363379,334,132322
993,2021/06/25 15:00:00+00,Male,2619,1506559,4042,1367421,360,132682
994,2021/06/26 15:00:00+00,Male,1798,1508357,3136,1370557,262,132944
995,2021/06/27 15:00:00+00,Male,1336,1509693,1669,1372226,128,133072
996,2021/06/28 15:00:00+00,Male,2204,1511897,2967,1375193,338,133410
997,2021/06/29 15:00:00+00,Male,2360,1514257,3068,1378261,306,133716
998,2021/06/30 15:00:00+00,Male,2619,1516876,3564,1381825,372,134088
999,2021/07/01 15:00:00+00,Male,2293,1519169,3101,1384926,295,134383
1000,2021/07/02 15:00:00+00,Male,2276,1521445,3093,1388019,321,134704
1001,2021/07/03 15:00:00+00,Male,1538,1522983,1919,1389938,170,134874
1002,2021/07/04 15:00:00+00,Male,213,1523196,231,1390169,30,134904
1003,2021/07/05 15:00:00+00,Male,1766,1524962,1902,1392071,179,135083
1004,2021/07/06 15:00:00+00,Male,2023,1526985,2955,1395026,290,135373
1005,2021/07/07 15:00:00+00,Male,2033,1529018,3033,1398059,328,135701
1006,2021/07/08 15:00:00+00,Male,2105,1531123,2845,1400904,343,136044
1007,2021/07/09 15:00:00+00,Male,2395,1533518,3016,1403920,354,136398
1008,2021/07/10 15:00:00+00,Male,1619,1535137,2043,1405963,175,136573
1009,2021/07/11 15:00:00+00,Male,1288,1536425,1192,1407155,158,136731
1010,2021/07/12 15:00:00+00,Male,2040,1538465,2426,1409581,235,136966
1011,2021/07/13 15:00:00+00,Male,2206,1540671,2210,1411791,244,137210
1012,2021/07/14 15:00:00+00,Male,2072,1542743,2402,1414193,292,137502
1013,2021/07/15 15:00:00+00,Male,2260,1545003,2224,1416417,239,137741
1014,2021/07/16 15:00:00+00,Male,2335,1547338,2453,1418870,253,137994
1015,2021/07/17 15:00:00+00,Male,1663,1549001,1709,1420579,197,138191
1016,2021/07/18 15:00:00+00,Male,1089,1550090,1099,1421678,63,138254
1017,2021/07/19 15:00:00+00,Male,2407,1552497,2090,1423768,218,138472
1018,2021/07/20 15:00:00+00,Male,2527,1555024,2221,1425989,220,138692
1019,2021/07/21 15:00:00+00,Male,2679,1557703,2333,1428322,268,138960
1020,2021/07/22 15:00:00+00,Male,2888,1560591,2074,1430396,322,139282
1021,2021/07/23 15:00:00+00,Male,3236,1563827,2207,1432603,324,139606
1022,2021/07/24 15:00:00+00,Male,2169,1565996,1562,1434165,183,139789
1023,2021/07/25 15:00:00+00,Male,1645,1567641,553,1434718,96,139885
1024,2021/07/26 15:00:00+00,Male,2982,1570623,1807,1436525,259,140144
1025,2021/07/27 15:00:00+00,Male,3183,1573806,1924,1438449,304,140448
1026,2021/07/28 15:00:00+00,Male,3385,1577191,1882,1440331,314,140762
1027,2021/07/29 15:00:00+00,Male,3342,1580533,1974,1442305,246,141008
1028,2021/07/30 15:00:00+00,Male,3716,1584249,2153,1444458,324,141332
1029,2021/07/31 15:00:00+00,Male,2341,1586590,1491,1445949,175,141507
1030,2021/08/01 15:00:00+00,Male,2001,1588591,1068,1447017,102,141609
1031,2021/08/02 15:00:00+00,Male,3546,1592137,1780,1448797,213,141822
1032,2021/08/03 15:00:00+00,Male,3464,1595601,1924,1450721,327,142149
1033,2021/08/04 15:00:00+00,Male,3585,1599186,1856,1452577,356,142505
1034,2021/08/05 15:00:00+00,Male,3821,1603007,1981,1454558,354,142859
1035,2021/08/06 15:00:00+00,Male,4009,1607016,2132,1456690,282,143141
1036,2021/08/07 15:00:00+00,Male,2661,1609677,1407,1458097,180,143321
1037,2021/08/08 15:00:00+00,Male,1953,1611630,1019,1459116,93,143414
1038,2021/08/09 15:00:00+00,Male,3405,1615035,2103,1461219,215,143629
1039,2021/08/10 15:00:00+00,Male,3365,1618400,2207,1463426,199,143828
1040,2021/08/11 15:00:00+00,Male,3405,1621805,2057,1465483,274,144102
1041,2021/08/12 15:00:00+00,Male,3147,1624952,2118,1467601,243,144345
1042,2021/08/13 15:00:00+00,Male,3382,1628334,2514,1470115,228,144573
1043,2021/08/14 15:00:00+00,Male,2411,1630745,1652,1471767,183,144756
1044,2021/08/15 15:00:00+00,Male,1689,1632434,1368,1473135,98,144854
1045,2021/08/16 15:00:00+00,Male,2658,1635092,2422,1475557,224,145078
1046,2021/08/17 15:00:00+00,Male,3308,1638400,2591,1478148,234,145312
1047,2021/08/18 15:00:00+00,Male,2997,1641397,2618,1480766,294,145606
1048,2021/08/19 15:00:00+00,Male,2953,1644350,2601,1483367,253,145859
1049,2021/08/20 15:00:00+00,Male,3236,1647586,3104,1486471,229,146088
1050,2021/08/21 15:00:00+00,Male,2044,1649630,1930,1488401,137,146225
1051,2021/08/22 15:00:00+00,Male,1512,1651142,1639,1490040,77,146302
1052,2021/08/23 15:00:00+00,Male,2863,1654005,2965,1493005,161,146463
1053,2021/08/24 15:00:00+00,Male,2997,1657002,2837,1495842,234,146697
1054,2021/08/25 15:00:00+00,Male,3131,1660133,2991,1498833,275,146972
1055,2021/08/26 15:00:00+00,Male,3177,1663310,3229,1502062,264,147236
1056,2021/08/27 15:00:00+00,Male,3028,1666338,3319,1505381,178,147414
1057,2021/08/28 15:00:00+00,Male,2335,1668673,2337,1507718,157,147571
1058,2021/08/29 15:00:00+00,Male,1696,1670369,1720,1509438,51,147622
1059,2021/08/30 15:00:00+00,Male,2778,1673147,3040,1512478,184,147806
1060,2021/08/31 15:00:00+00,Male,2636,1675783,2920,1515398,176,147982
1061,2021/09/01 15:00:00+00,Male,2561,1678344,2703,1518101,241,148223
1062,2021/09/02 15:00:00+00,Male,2342,1680686,2674,1520775,184,148407
1063,2021/09/03 15:00:00+00,Male,2651,1683337,3202,1523977,159,148566
1064,2021/09/04 15:00:00+00,Male,1719,1685056,2015,1525992,85,148651
1065,2021/09/05 15:00:00+00,Male,1404,1686460,1444,1527436,63,148714
1066,2021/09/06 15:00:00+00,Male,513,1686973,562,1527998,46,148760
1067,2021/09/07 15:00:00+00,Male,2401,1689374,3427,1531425,169,148929
1068,2021/09/08 15:00:00+00,Male,2144,1691518,2571,1533996,235,149164
1069,2021/09/09 15:00:00+00,Male,2290,1693808,2505,1536501,200,149364
1070,2021/09/10 15:00:00+00,Male,2550,1696358,2850,1539351,241,149605
1071,2021/09/11 15:00:00+00,Male,1860,1698218,2013,1541364,169,149774
1072,2021/09/12 15:00:00+00,Male,1330,1699548,1432,1542796,54,149828
1073,2021/09/13 15:00:00+00,Male,2261,1701809,2370,1545166,142,149970
1074,2021/09/14 15:00:00+00,Male,2241,1704050,2483,1547649,189,150159
1075,2021/09/15 15:00:00+00,Male,2328,1706378,2705,1550354,192,150351
1076,2021/09/16 15:00:00+00,Male,2126,1708504,2571,1552925,176,150527
1077,2021/09/17 15:00:00+00,Male,2256,1710760,2801,1555726,201,150728
1078,2021/09/18 15:00:00+00,Male,1707,1712467,2153,1557879,75,150803
1079,2021/09/19 15:00:00+00,Male,1187,1713654,1459,1559338,34,150837
1080,2021/09/20 15:00:00+00,Male,1777,1715431,2114,1561452,156,150993
1081,2021/09/21 15:00:00+00,Male,1884,1717315,2243,1563695,167,151160
1082,2021/09/22 15:00:00+00,Male,1861,1719176,2144,1565839,177,151337
1083,2021/09/23 15:00:00+00,Male,1879,1721055,1991,1567830,138,151475
1084,2021/09/24 15:00:00+00,Male,2131,1723186,2336,1570166,183,151658
1085,2021/09/25 15:00:00+00,Male,1520,1724706,1628,1571794,36,151694
1086,2021/09/26 15:00:00+00,Male,1014,1725720,1148,1572942,38,151732
1087,2021/09/27 15:00:00+00,Male,2100,1727820,1308,1574250,142,151874
1088,2021/09/28 15:00:00+00,Male,2034,1729854,2078,1576328,125,151999
1089,2021/09/29 15:00:00+00,Male,2031,1731885,1945,1578273,160,152159
1090,2021/09/30 15:00:00+00,Male,2089,1733974,1832,1580105,149,152308
1091,2021/10/01 15:00:00+00,Male,2333,1736307,2206,1582311,180,152488
1092,2021/10/02 15:00:00+00,Male,1343,1737650,1408,1583719,58,152546
1093,2021/10/03 15:00:00+00,Male,951,1738601,1140,1584859,52,152598
1094,2021/10/04 15:00:00+00,Male,1856,1740457,1618,1586477,163,152761
1095,2021/10/05 15:00:00+00,Male,1893,1742350,1741,1588218,129,152890
1096,2021/10/06 15:00:00+00,Male,1881,1744231,1639,1589857,161,153051
1097,2021/10/07 15:00:00+00,Male,1915,1746146,1655,1591512,144,153195
1098,2021/10/08 15:00:00+00,Male,2094,1748240,1931,1593443,142,153337
1099,2021/10/09 15:00:00+00,Male,1246,1749486,1292,1594735,78,153415
1100,2021/10/10 15:00:00+00,Male,860,1750346,906,1595641,29,153444
1101,2021/10/11 15:00:00+00,Male,1939,1752285,1499,1597140,149,153593
1102,2021/10/12 15:00:00+00,Male,1624,1753909,1652,1598792,168,153761
1103,2021/10/13 15:00:00+00,Male,1880,1755789,1608,1600400,217,153978
1104,2021/10/14 15:00:00+00,Male,1836,1757625,1599,1601999,166,154144
1105,2021/10/15 15:00:00+00,Male,1952,1759577,1830,1603829,197,154341
1106,2021/10/16 15:00:00+00,Male,1099,1760676,1154,1604983,82,154423
1107,2021/10/17 15:00:00+00,Male,711,1761387,721,1605704,26,154449
1108,2021/10/18 15:00:00+00,Male,1896,1763283,1606,1607310,172,154621
1109,2021/10/19 15:00:00+00,Male,1607,1764890,1364,1608674,133,154754
1110,2021/10/20 15:00:00+00,Male,1520,1766410,1500,1610174,158,154912
1111,2021/10/21 15:00:00+00,Male,1631,1768041,1479,1611653,192,155104
1112,2021/10/22 15:00:00+00,Male,2066,1770107,1606,1613259,184,155288
1113,2021/10/23 15:00:00+00,Male,1329,1771436,938,1614197,81,155369
1114,2021/10/24 15:00:00+00,Male,890,1772326,623,1614820,44,155413
1115,2021/10/25 15:00:00+00,Male,2219,1774545,1420,1616240,208,155621
1116,2021/10/26 15:00:00+00,Male,2189,1776734,1419,1617659,192,155813
1117,2021/10/27 15:00:00+00,Male,2170,1778904,1408,1619067,267,156080
1118,2021/10/28 15:00:00+00,Male,2102,1781006,1444,1620511,210,156290
1119,2021/10/29 15:00:00+00,Male,2242,1783248,1582,1622093,251,156541
1120,2021/10/30 15:00:00+00,Male,1247,1784495,844,1622937,89,156630
1121,2021/03/09 15:00:00+00,Unknown,139,10131,10,8937,4,11
1122,2021/03/10 15:00:00+00,Unknown,76,10207,38,8975,4,15
1123,2021/03/11 15:00:00+00,Unknown,84,10291,19,8994,1,16
1124,2021/03/12 15:00:00+00,Unknown,76,10367,14,9008,5,21
1125,2021/03/13 15:00:00+00,Unknown,12,10379,3,9011,8,29
1126,2021/03/14 15:00:00+00,Unknown,19,10398,2,9013,1,30
1127,2021/03/15 15:00:00+00,Unknown,188,10586,6,9019,,30
1128,2021/03/16 15:00:00+00,Unknown,201,10787,65,9084,,30
1129,2021/03/17 15:00:00+00,Unknown,165,10952,69,9153,,30
1130,2021/03/18 15:00:00+00,Unknown,232,11184,14,9167,24,54
1131,2021/03/19 15:00:00+00,Unknown,159,11343,21,9188,1,55
1132,2021/03/20 15:00:00+00,Unknown,38,11381,5,9193,4,59
1133,2021/03/21 15:00:00+00,Unknown,16,11397,50,9243,,59
1134,2021/03/22 15:00:00+00,Unknown,42,11439,38,9281,7,66
1135,2021/03/23 15:00:00+00,Unknown,90,11529,67,9348,6,72
1136,2021/03/24 15:00:00+00,Unknown,313,11842,19,9367,10,82
1137,2021/03/25 15:00:00+00,Unknown,195,12037,10,9377,88,170
1138,2021/03/26 15:00:00+00,Unknown,194,12231,22,9399,91,261
1139,2021/03/27 15:00:00+00,Unknown,15,12246,7,9406,4,265
1140,2021/03/28 15:00:00+00,Unknown,18,12264,6,9412,1,266
1141,2021/03/29 15:00:00+00,Unknown,22,12286,101,9513,15,281
1142,2021/03/30 15:00:00+00,Unknown,28,12314,115,9628,17,298
1143,2021/03/31 15:00:00+00,Unknown,96,12410,73,9701,74,372
1144,2021/04/01 15:00:00+00,Unknown,110,12520,51,9752,25,397
1145,2021/04/02 15:00:00+00,Unknown,138,12658,92,9844,25,422
1146,2021/04/03 15:00:00+00,Unknown,12,12670,15,9859,16,438
1147,2021/04/04 15:00:00+00,Unknown,2,12672,5,9864,1,439
1148,2021/04/05 15:00:00+00,Unknown,101,12773,35,9899,30,469
1149,2021/04/06 15:00:00+00,Unknown,120,12893,131,10030,41,510
1150,2021/04/07 15:00:00+00,Unknown,87,12980,99,10129,57,567
1151,2021/04/08 15:00:00+00,Unknown,85,13065,187,10316,51,618
1152,2021/04/09 15:00:00+00,Unknown,115,13180,49,10365,63,681
1153,2021/04/10 15:00:00+00,Unknown,20,13200,32,10397,28,709
1154,2021/04/11 15:00:00+00,Unknown,9,13209,17,10414,16,725
1155,2021/04/12 15:00:00+00,Unknown,39,13248,166,10580,43,768
1156,2021/04/13 15:00:00+00,Unknown,58,13306,135,10715,9,777
1157,2021/04/14 15:00:00+00,Unknown,83,13389,122,10837,,777
1158,2021/04/15 15:00:00+00,Unknown,95,13484,98,10935,1,778
1159,2021/04/16 15:00:00+00,Unknown,141,13625,124,11059,,778
1160,2021/04/17 15:00:00+00,Unknown,107,13732,16,11075,,778
1161,2021/04/18 15:00:00+00,Unknown,61,13793,16,11091,,778
1162,2021/04/19 15:00:00+00,Unknown,45,13838,16,11107,,778
1163,2021/04/20 15:00:00+00,Unknown,71,13909,30,11137,1,779
1164,2021/04/21 15:00:00+00,Unknown,87,13996,301,11438,,779
1165,2021/04/22 15:00:00+00,Unknown,94,14090,187,11625,,779
1166,2021/04/23 15:00:00+00,Unknown,74,14164,206,11831,,779
1167,2021/04/24 15:00:00+00,Unknown,34,14198,15,11846,,779
1168,2021/04/25 15:00:00+00,Unknown,39,14237,1,11847,,779
1169,2021/04/26 15:00:00+00,Unknown,52,14289,19,11866,8,787
1170,2021/04/27 15:00:00+00,Unknown,59,14348,34,11900,15,802
1171,2021/04/28 15:00:00+00,Unknown,57,14405,62,11962,14,816
1172,2021/04/29 15:00:00+00,Unknown,40,14445,69,12031,8,824
1173,2021/04/30 15:00:00+00,Unknown,119,14564,78,12109,13,837
1174,2021/05/01 15:00:00+00,Unknown,43,14607,11,12120,,837
1175,2021/05/02 15:00:00+00,Unknown,14,14621,6,12126,,837
1176,2021/05/03 15:00:00+00,Unknown,44,14665,89,12215,9,846
1177,2021/05/04 15:00:00+00,Unknown,25,14690,110,12325,9,855
1178,2021/05/05 15:00:00+00,Unknown,63,14753,89,12414,10,865
1179,2021/05/06 15:00:00+00,Unknown,57,14810,75,12489,9,874
1180,2021/05/07 15:00:00+00,Unknown,63,14873,106,12595,8,882
1181,2021/05/08 15:00:00+00,Unknown,29,14902,33,12628,9,891
1182,2021/05/09 15:00:00+00,Unknown,16,14918,8,12636,,891
1183,2021/05/10 15:00:00+00,Unknown,21,14939,30,12666,5,896
1184,2021/05/11 15:00:00+00,Unknown,36,14975,34,12700,4,900
1185,2021/05/12 15:00:00+00,Unknown,24,14999,74,12774,5,905
1186,2021/05/13 15:00:00+00,Unknown,30,15029,70,12844,13,918
1187,2021/05/14 15:00:00+00,Unknown,64,15093,122,12966,16,934
1188,2021/05/15 15:00:00+00,Unknown,19,15112,79,13045,9,943
1189,2021/05/16 15:00:00+00,Unknown,7,15119,45,13090,2,945
1190,2021/05/17 15:00:00+00,Unknown,25,15144,40,13130,27,972
1191,2021/10/31 15:00:00+00,Male,845,1785340,611,1623548,49,156679
1192,2021/11/01 15:00:00+00,Male,2130,1787470,1462,1625010,208,156887
1193,2021/11/02 15:00:00+00,Male,2060,1789530,1351,1626361,260,157147
1194,2021/11/03 15:00:00+00,Male,2129,1791659,1403,1627764,296,157443
1195,2021/11/04 15:00:00+00,Male,2989,1794648,1493,1629257,241,157684
1196,2021/11/05 15:00:00+00,Male,3844,1798492,1619,1630876,251,157935
1197,2021/11/06 15:00:00+00,Male,4881,1803373,889,1631765,116,158051
1198,2021/11/07 15:00:00+00,Male,3835,1807208,611,1632376,55,158106
1199,2021/11/08 15:00:00+00,Male,5631,1812839,1382,1633758,246,158352
1200,2021/11/09 15:00:00+00,Male,5776,1818615,1228,1634986,168,158520
1201,2021/11/10 15:00:00+00,Male,6207,1824822,1205,1636191,208,158728
1202,2021/11/11 15:00:00+00,Male,5623,1830445,1106,1637297,167,158895
1203,2021/11/12 15:00:00+00,Male,5778,1836223,1394,1638691,191,159086
1204,2021/11/13 15:00:00+00,Male,4922,1841145,778,1639469,92,159178
1205,2021/11/14 15:00:00+00,Male,2034,1843179,523,1639992,42,159220
1206,2021/11/15 15:00:00+00,Male,4229,1847408,1206,1641198,123,159343
1207,2021/11/16 15:00:00+00,Male,4500,1851908,1188,1642386,161,159504
1208,2021/11/17 15:00:00+00,Male,4540,1856448,1252,1643638,200,159704
1209,2021/11/18 15:00:00+00,Male,4420,1860868,1187,1644825,183,159887
1210,2021/11/19 15:00:00+00,Male,4621,1865489,1370,1646195,217,160104
1211,2021/11/20 15:00:00+00,Male,5163,1870652,709,1646904,110,160214
1212,2021/11/21 15:00:00+00,Male,2024,1872676,501,1647405,43,160257
1213,2021/11/22 15:00:00+00,Male,4862,1877538,1232,1648637,181,160438
1214,2021/11/23 15:00:00+00,Male,4522,1882060,1223,1649860,186,160624
1215,2021/11/24 15:00:00+00,Male,4033,1886093,1176,1651036,126,160750
1216,2021/11/25 15:00:00+00,Male,121,1886214,34,1651070,4,160754
1217,2021/11/26 15:00:00+00,Male,2566,1888780,1800,1652870,84,160838
1218,2021/11/27 15:00:00+00,Male,1802,1890582,2692,1655562,81,160919
1219,2021/11/28 15:00:00+00,Male,1114,1891696,3229,1658791,41,160960
1220,2021/11/29 15:00:00+00,Male,2827,1894523,4484,1663275,120,161080
1221,2021/11/30 15:00:00+00,Male,3008,1897531,4660,1667935,137,161217
1222,2021/12/01 15:00:00+00,Male,3561,1901092,4764,1672699,194,161411
1223,2021/12/02 15:00:00+00,Male,3127,1904219,4273,1676972,153,161564
1224,2021/12/03 15:00:00+00,Male,3648,1907867,4715,1681687,131,161695
1225,2021/12/04 15:00:00+00,Male,2491,1910358,4913,1686600,85,161780
1226,2021/12/05 15:00:00+00,Male,1442,1911800,1662,1688262,34,161814
1227,2021/12/06 15:00:00+00,Male,3322,1915122,3521,1691783,165,161979
1228,2021/12/07 15:00:00+00,Male,3112,1918234,3485,1695268,138,162117
1229,2021/12/08 15:00:00+00,Male,3204,1921438,3507,1698775,200,162317
1230,2021/12/09 15:00:00+00,Male,3074,1924512,3443,1702218,134,162451
1231,2021/12/10 15:00:00+00,Male,3300,1927812,3557,1705775,170,162621
1232,2021/12/11 15:00:00+00,Male,2048,1929860,3902,1709677,57,162678
1233,2021/12/12 15:00:00+00,Male,1941,1931801,1374,1711051,41,162719
1234,2021/12/13 15:00:00+00,Male,2833,1934634,2896,1713947,144,162863
1235,2021/12/14 15:00:00+00,Male,2973,1937607,2831,1716778,122,162985
1236,2021/12/15 15:00:00+00,Male,3318,1940925,2558,1719336,143,163128
1237,2021/12/16 15:00:00+00,Male,3777,1944702,1323,1720659,148,163276
1238,2021/12/17 15:00:00+00,Male,3561,1948263,1930,1722589,110,163386
1239,2021/12/18 15:00:00+00,Male,2773,1951036,1579,1724168,39,163425
1240,2021/12/19 15:00:00+00,Male,1653,1952689,642,1724810,19,163444
1241,2021/12/20 15:00:00+00,Male,3897,1956586,1879,1726689,88,163532
1242,2021/12/21 15:00:00+00,Male,4187,1960773,1927,1728616,119,163651
1243,2021/12/22 15:00:00+00,Male,4330,1965103,1901,1730517,112,163763
1244,2021/12/23 15:00:00+00,Male,3947,1969050,1568,1732085,113,163876
1245,2021/12/24 15:00:00+00,Male,856,1969906,528,1732613,23,163899
1246,2021/12/25 15:00:00+00,Male,28,1969934,16,1732629,,163899
1247,2021/12/26 15:00:00+00,Male,1006,1970940,746,1733375,22,163921
1248,2021/12/27 15:00:00+00,Male,3347,1974287,1962,1735337,84,164005
1249,2021/12/28 15:00:00+00,Male,3860,1978147,1909,1737246,112,164117
1250,2021/12/29 15:00:00+00,Male,3985,1982132,1985,1739231,98,164215
1251,2021/12/30 15:00:00+00,Male,3619,1985751,1802,1741033,97,164312
1252,2021/12/31 15:00:00+00,Male,1288,1987039,741,1741774,61,164373
1253,2022/01/01 15:00:00+00,Male,357,1987396,161,1741935,18,164391
1254,2022/01/02 15:00:00+00,Male,968,1988364,715,1742650,26,164417
1255,2022/01/03 15:00:00+00,Male,1737,1990101,1087,1743737,55,164472
1256,2022/01/04 15:00:00+00,Male,2902,1993003,1719,1745456,92,164564
1257,2022/01/05 15:00:00+00,Male,3403,1996406,2342,1747798,107,164671
1258,2022/01/06 15:00:00+00,Male,3319,1999725,2345,1750143,100,164771
1259,2022/01/07 15:00:00+00,Male,2867,2002592,1831,1751974,98,164869
1260,2022/01/08 15:00:00+00,Male,2399,2004991,2016,1753990,49,164918
1261,2022/01/09 15:00:00+00,Male,1320,2006311,1016,1755006,25,164943
1262,2022/01/10 15:00:00+00,Male,3080,2009391,1910,1756916,98,165041
1263,2021/05/18 15:00:00+00,Unknown,27,15171,54,13184,22,994
1264,2021/05/19 15:00:00+00,Unknown,44,15215,80,13264,10,1004
1265,2021/05/20 15:00:00+00,Unknown,107,15322,69,13333,6,1010
1266,2021/05/21 15:00:00+00,Unknown,65,15387,68,13401,8,1018
1267,2021/05/22 15:00:00+00,Unknown,21,15408,16,13417,2,1020
1268,2021/05/23 15:00:00+00,Unknown,20,15428,17,13434,9,1029
1269,2021/05/24 15:00:00+00,Unknown,16,15444,51,13485,13,1042
1270,2021/05/25 15:00:00+00,Unknown,31,15475,42,13527,9,1051
1271,2021/05/26 15:00:00+00,Unknown,33,15508,45,13572,7,1058
1272,2021/05/27 15:00:00+00,Unknown,41,15549,35,13607,8,1066
1273,2021/05/28 15:00:00+00,Unknown,25,15574,73,13680,3,1069
1274,2021/05/29 15:00:00+00,Unknown,12,15586,43,13723,3,1072
1275,2021/05/30 15:00:00+00,Unknown,3,15589,15,13738,1,1073
1276,2021/05/31 15:00:00+00,Unknown,3,15592,2,13740,1,1074
1277,2021/06/01 15:00:00+00,Unknown,20,15612,40,13780,6,1080
1278,2021/06/02 15:00:00+00,Unknown,13,15625,39,13819,4,1084
1279,2021/06/03 15:00:00+00,Unknown,17,15642,48,13867,9,1093
1280,2021/06/04 15:00:00+00,Unknown,19,15661,53,13920,16,1109
1281,2021/06/05 15:00:00+00,Unknown,6,15667,19,13939,1,1110
1282,2021/06/06 15:00:00+00,Unknown,6,15673,9,13948,,1110
1283,2021/06/07 15:00:00+00,Unknown,12,15685,32,13980,2,1112
1284,2021/06/08 15:00:00+00,Unknown,24,15709,26,14006,3,1115
1285,2021/06/09 15:00:00+00,Unknown,31,15740,37,14043,3,1118
1286,2021/06/10 15:00:00+00,Unknown,24,15764,25,14068,2,1120
1287,2021/06/11 15:00:00+00,Unknown,20,15784,56,14124,4,1124
1288,2021/06/12 15:00:00+00,Unknown,16,15800,20,14144,1,1125
1289,2021/06/13 15:00:00+00,Unknown,3,15803,8,14152,2,1127
1290,2021/06/14 15:00:00+00,Unknown,17,15820,10,14162,9,1136
1291,2021/06/15 15:00:00+00,Unknown,38,15858,19,14181,8,1144
1292,2021/06/16 15:00:00+00,Unknown,38,15896,24,14205,6,1150
1293,2021/06/17 15:00:00+00,Unknown,28,15924,102,14307,1,1151
1294,2021/06/18 15:00:00+00,Unknown,67,15991,55,14362,15,1166
1295,2021/06/19 15:00:00+00,Unknown,52,16043,16,14378,4,1170
1296,2021/06/20 15:00:00+00,Unknown,40,16083,10,14388,1,1171
1297,2021/06/21 15:00:00+00,Unknown,32,16115,10,14398,,1171
1298,2021/06/22 15:00:00+00,Unknown,23,16138,20,14418,2,1173
1299,2021/06/23 15:00:00+00,Unknown,46,16184,16,14434,6,1179
1300,2021/06/24 15:00:00+00,Unknown,58,16242,28,14462,5,1184
1301,2021/06/25 15:00:00+00,Unknown,41,16283,26,14488,1,1185
1302,2021/06/26 15:00:00+00,Unknown,19,16302,5,14493,2,1187
1303,2021/06/27 15:00:00+00,Unknown,70,16372,4,14497,,1187
1304,2021/06/28 15:00:00+00,Unknown,11,16383,6,14503,2,1189
1305,2021/06/29 15:00:00+00,Unknown,30,16413,11,14514,1,1190
1306,2021/06/30 15:00:00+00,Unknown,22,16435,14,14528,1,1191
1307,2021/07/01 15:00:00+00,Unknown,16,16451,11,14539,,1191
1308,2021/07/02 15:00:00+00,Unknown,28,16479,8,14547,2,1193
1309,2021/07/03 15:00:00+00,Unknown,15,16494,3,14550,1,1194
1310,2021/07/04 15:00:00+00,Unknown,14,16508,2,14552,2,1196
1311,2021/07/05 15:00:00+00,Unknown,9,16517,4,14556,1,1197
1312,2021/07/06 15:00:00+00,Unknown,38,16555,19,14575,1,1198
1313,2021/07/07 15:00:00+00,Unknown,29,16584,24,14599,2,1200
1314,2021/07/08 15:00:00+00,Unknown,46,16630,9,14608,3,1203
1315,2021/07/09 15:00:00+00,Unknown,54,16684,29,14637,5,1208
1316,2021/07/10 15:00:00+00,Unknown,57,16741,10,14647,6,1214
1317,2021/07/11 15:00:00+00,Unknown,27,16768,20,14667,1,1215
1318,2021/07/12 15:00:00+00,Unknown,18,16786,14,14681,3,1218
1319,2021/07/13 15:00:00+00,Unknown,10,16796,7,14688,2,1220
1320,2021/07/14 15:00:00+00,Unknown,25,16821,13,14701,2,1222
1321,2021/07/15 15:00:00+00,Unknown,33,16854,21,14722,3,1225
1322,2021/07/16 15:00:00+00,Unknown,50,16904,45,14767,2,1227
1323,2021/07/17 15:00:00+00,Unknown,19,16923,13,14780,1,1228
1324,2021/07/18 15:00:00+00,Unknown,36,16959,25,14805,,1228
1325,2021/07/19 15:00:00+00,Unknown,25,16984,14,14819,4,1232
1326,2021/07/20 15:00:00+00,Unknown,37,17021,16,14835,7,1239
1327,2021/07/21 15:00:00+00,Unknown,29,17050,42,14877,2,1241
1328,2021/07/22 15:00:00+00,Unknown,27,17077,17,14894,,1241
1329,2021/07/23 15:00:00+00,Unknown,50,17127,25,14919,2,1243
1330,2021/07/24 15:00:00+00,Unknown,46,17173,13,14932,6,1249
1331,2021/07/25 15:00:00+00,Unknown,70,17243,20,14952,2,1251
1332,2021/07/26 15:00:00+00,Unknown,20,17263,8,14960,6,1257
1333,2022/01/11 15:00:00+00,Male,3200,2012591,2136,1759052,83,165124
1334,2022/01/12 15:00:00+00,Male,3395,2015986,2278,1761330,113,165237
1335,2022/01/13 15:00:00+00,Male,3176,2019162,1995,1763325,89,165326
1336,2022/01/14 15:00:00+00,Male,3488,2022650,1578,1764903,81,165407
1337,2022/01/15 15:00:00+00,Male,2055,2024705,822,1765725,37,165444
1338,2022/01/16 15:00:00+00,Male,984,2025689,555,1766280,9,165453
1339,2022/01/17 15:00:00+00,Male,1805,2027494,1167,1767447,43,165496
1340,2022/01/18 15:00:00+00,Male,2406,2029900,1980,1769427,60,165556
1341,2022/01/19 15:00:00+00,Male,2616,2032516,2220,1771647,57,165613
1342,2022/01/20 15:00:00+00,Male,2198,2034714,1771,1773418,49,165662
1343,2022/01/21 15:00:00+00,Male,2593,2037307,1314,1774732,74,165736
1344,2022/01/22 15:00:00+00,Male,1641,2038948,830,1775562,53,165789
1345,2022/01/23 15:00:00+00,Male,935,2039883,672,1776234,12,165801
1346,2022/01/24 15:00:00+00,Male,1949,2041832,1342,1777576,59,165860
1347,2022/01/25 15:00:00+00,Male,1896,2043728,1677,1779253,45,165905
1348,2022/01/26 15:00:00+00,Male,1801,2045529,1837,1781090,52,165957
1349,2022/01/27 15:00:00+00,Male,1737,2047266,1962,1783052,42,165999
1350,2022/01/28 15:00:00+00,Male,1756,2049022,1576,1784628,39,166038
1351,2022/01/29 15:00:00+00,Male,1123,2050145,1146,1785774,19,166057
1352,2022/01/30 15:00:00+00,Male,685,2050830,793,1786567,9,166066
1353,2022/01/31 15:00:00+00,Male,1435,2052265,1597,1788164,33,166099
1354,2022/02/01 15:00:00+00,Male,1264,2053529,1708,1789872,42,166141
1355,2022/02/02 15:00:00+00,Male,1350,2054879,1848,1791720,44,166185
1356,2022/02/03 15:00:00+00,Male,1337,2056216,1808,1793528,27,166212
1357,2022/02/04 15:00:00+00,Male,1296,2057512,2157,1795685,34,166246
1358,2022/02/05 15:00:00+00,Male,904,2058416,1452,1797137,24,166270
1359,2022/02/06 15:00:00+00,Male,478,2058894,632,1797769,12,166282
1360,2022/02/07 15:00:00+00,Male,983,2059877,1370,1799139,32,166314
1361,2022/02/08 15:00:00+00,Male,1018,2060895,1498,1800637,44,166358
1362,2022/02/09 15:00:00+00,Male,1064,2061959,1638,1802275,48,166406
1363,2022/02/10 15:00:00+00,Male,1040,2062999,1442,1803717,37,166443
1364,2022/02/11 15:00:00+00,Male,1189,2064188,1681,1805398,38,166481
1365,2022/02/12 15:00:00+00,Male,747,2064935,1151,1806549,16,166497
1366,2022/02/13 15:00:00+00,Male,329,2065264,506,1807055,8,166505
1367,2022/02/14 15:00:00+00,Male,756,2066020,1098,1808153,40,166545
1368,2022/02/15 15:00:00+00,Male,1025,2067045,1237,1809390,25,166570
1369,2022/02/16 15:00:00+00,Male,828,2067873,1178,1810568,29,166599
1370,2022/02/17 15:00:00+00,Male,821,2068694,1106,1811674,28,166627
1371,2022/02/18 15:00:00+00,Male,887,2069581,1180,1812854,32,166659
1372,2022/02/19 15:00:00+00,Male,578,2070159,890,1813744,8,166667
1373,2022/02/20 15:00:00+00,Male,335,2070494,422,1814166,8,166675
1374,2022/02/21 15:00:00+00,Male,636,2071130,851,1815017,17,166692
1375,2022/02/22 15:00:00+00,Male,726,2071856,928,1815945,19,166711
1376,2022/02/23 15:00:00+00,Male,748,2072604,919,1816864,20,166731
1377,2022/02/24 15:00:00+00,Male,744,2073348,818,1817682,30,166761
1378,2022/02/25 15:00:00+00,Male,787,2074135,856,1818538,21,166782
1379,2022/02/26 15:00:00+00,Male,504,2074639,603,1819141,9,166791
1380,2022/02/27 15:00:00+00,Male,240,2074879,256,1819397,11,166802
1381,2022/02/28 15:00:00+00,Male,569,2075448,613,1820010,22,166824
1382,2022/03/01 15:00:00+00,Male,567,2076015,614,1820624,11,166835
1383,2022/03/02 15:00:00+00,Male,574,2076589,653,1821277,22,166857
1384,2022/03/03 15:00:00+00,Male,606,2077195,598,1821875,20,166877
1385,2022/03/04 15:00:00+00,Male,646,2077841,746,1822621,21,166898
1386,2022/03/05 15:00:00+00,Male,372,2078213,443,1823064,14,166912
1387,2022/03/06 15:00:00+00,Male,202,2078415,192,1823256,2,166914
1388,2022/03/07 15:00:00+00,Male,453,2078868,428,1823684,17,166931
1389,2022/03/08 15:00:00+00,Male,541,2079409,500,1824184,19,166950
1390,2022/03/09 15:00:00+00,Male,447,2079856,480,1824664,27,166977
1391,2022/03/10 15:00:00+00,Male,434,2080290,492,1825156,12,166989
1392,2022/03/11 15:00:00+00,Male,511,2080801,629,1825785,12,167001
1393,2022/03/12 15:00:00+00,Male,208,2081009,274,1826059,5,167006
1394,2022/03/13 15:00:00+00,Male,164,2081173,211,1826270,2,167008
1395,2022/03/14 15:00:00+00,Male,404,2081577,333,1826603,10,167018
1396,2022/03/15 15:00:00+00,Male,427,2082004,413,1827016,7,167025
1397,2022/03/16 15:00:00+00,Male,374,2082378,410,1827426,13,167038
1398,2022/03/17 15:00:00+00,Male,371,2082749,441,1827867,13,167051
1399,2022/03/18 15:00:00+00,Male,459,2083208,470,1828337,15,167066
1400,2022/03/19 15:00:00+00,Male,247,2083455,294,1828631,5,167071
1401,2022/03/20 15:00:00+00,Male,152,2083607,150,1828781,1,167072
1402,2022/03/21 15:00:00+00,Male,174,2083781,179,1828960,9,167081
1403,2021/07/27 15:00:00+00,Unknown,66,17329,9,14969,9,1266
1404,2021/07/28 15:00:00+00,Unknown,38,17367,12,14981,3,1269
1405,2021/07/29 15:00:00+00,Unknown,38,17405,32,15013,3,1272
1406,2021/07/30 15:00:00+00,Unknown,74,17479,28,15041,6,1278
1407,2021/07/31 15:00:00+00,Unknown,73,17552,14,15055,5,1283
1408,2021/08/01 15:00:00+00,Unknown,112,17664,23,15078,,1283
1409,2021/08/02 15:00:00+00,Unknown,32,17696,12,15090,1,1284
1410,2021/08/03 15:00:00+00,Unknown,49,17745,15,15105,6,1290
1411,2021/08/04 15:00:00+00,Unknown,28,17773,23,15128,2,1292
1412,2021/08/05 15:00:00+00,Unknown,80,17853,20,15148,4,1296
1413,2021/08/06 15:00:00+00,Unknown,94,17947,32,15180,2,1298
1414,2021/08/07 15:00:00+00,Unknown,46,17993,12,15192,1,1299
1415,2021/08/08 15:00:00+00,Unknown,84,18077,20,15212,,1299
1416,2021/08/09 15:00:00+00,Unknown,41,18118,13,15225,2,1301
1417,2021/08/10 15:00:00+00,Unknown,88,18206,16,15241,2,1303
1418,2021/08/11 15:00:00+00,Unknown,41,18247,18,15259,6,1309
1419,2021/08/12 15:00:00+00,Unknown,35,18282,17,15276,2,1311
1420,2021/08/13 15:00:00+00,Unknown,64,18346,32,15308,1,1312
1421,2021/08/14 15:00:00+00,Unknown,52,18398,27,15335,2,1314
1422,2021/08/15 15:00:00+00,Unknown,85,18483,13,15348,,1314
1423,2021/08/16 15:00:00+00,Unknown,32,18515,11,15359,2,1316
1424,2021/08/17 15:00:00+00,Unknown,73,18588,29,15388,4,1320
1425,2021/08/18 15:00:00+00,Unknown,47,18635,13,15401,6,1326
1426,2021/08/19 15:00:00+00,Unknown,30,18665,20,15421,5,1331
1427,2021/08/20 15:00:00+00,Unknown,103,18768,45,15466,5,1336
1428,2021/08/21 15:00:00+00,Unknown,49,18817,32,15498,,1336
1429,2021/08/22 15:00:00+00,Unknown,82,18899,39,15537,1,1337
1430,2021/08/23 15:00:00+00,Unknown,26,18925,16,15553,2,1339
1431,2021/08/24 15:00:00+00,Unknown,44,18969,28,15581,1,1340
1432,2021/08/25 15:00:00+00,Unknown,27,18996,38,15619,3,1343
1433,2021/08/26 15:00:00+00,Unknown,51,19047,31,15650,1,1344
1434,2021/08/27 15:00:00+00,Unknown,70,19117,56,15706,4,1348
1435,2021/08/28 15:00:00+00,Unknown,63,19180,35,15741,7,1355
1436,2021/08/29 15:00:00+00,Unknown,69,19249,68,15809,,1355
1437,2021/08/30 15:00:00+00,Unknown,17,19266,23,15832,8,1363
1438,2021/08/31 15:00:00+00,Unknown,67,19333,47,15879,9,1372
1439,2021/09/01 15:00:00+00,Unknown,38,19371,16,15895,3,1375
1440,2021/09/02 15:00:00+00,Unknown,43,19414,36,15931,8,1383
1441,2021/09/03 15:00:00+00,Unknown,86,19500,47,15978,7,1390
1442,2021/09/04 15:00:00+00,Unknown,40,19540,48,16026,2,1392
1443,2021/09/05 15:00:00+00,Unknown,97,19637,46,16072,5,1397
1444,2021/09/06 15:00:00+00,Unknown,6,19643,8,16080,2,1399
1445,2021/09/07 15:00:00+00,Unknown,41,19684,45,16125,10,1409
1446,2021/09/08 15:00:00+00,Unknown,29,19713,28,16153,9,1418
1447,2021/09/09 15:00:00+00,Unknown,29,19742,27,16180,6,1424
1448,2021/09/10 15:00:00+00,Unknown,63,19805,54,16234,5,1429
1449,2021/09/11 15:00:00+00,Unknown,23,19828,12,16246,6,1435
1450,2021/09/12 15:00:00+00,Unknown,53,19881,38,16284,5,1440
1451,2021/09/13 15:00:00+00,Unknown,15,19896,19,16303,11,1451
1452,2021/09/14 15:00:00+00,Unknown,49,19945,54,16357,7,1458
1453,2021/09/15 15:00:00+00,Unknown,54,19999,28,16385,7,1465
1454,2021/09/16 15:00:00+00,Unknown,22,20021,21,16406,11,1476
1455,2021/09/17 15:00:00+00,Unknown,68,20089,63,16469,4,1480
1456,2021/09/18 15:00:00+00,Unknown,41,20130,37,16506,3,1483
1457,2021/09/19 15:00:00+00,Unknown,28,20158,19,16525,2,1485
1458,2021/09/20 15:00:00+00,Unknown,22,20180,17,16542,10,1495
1459,2021/09/21 15:00:00+00,Unknown,46,20226,44,16586,11,1506
1460,2021/09/22 15:00:00+00,Unknown,27,20253,8,16594,2,1508
1461,2021/09/23 15:00:00+00,Unknown,23,20276,33,16627,4,1512
1462,2021/09/24 15:00:00+00,Unknown,74,20350,42,16669,,1512
1463,2021/09/25 15:00:00+00,Unknown,49,20399,23,16692,1,1513
1464,2021/09/26 15:00:00+00,Unknown,42,20441,29,16721,10,1523
1465,2021/09/27 15:00:00+00,Unknown,13,20454,15,16736,9,1532
1466,2021/09/28 15:00:00+00,Unknown,29,20483,48,16784,3,1535
1467,2021/09/29 15:00:00+00,Unknown,39,20522,18,16802,6,1541
1468,2021/09/30 15:00:00+00,Unknown,23,20545,31,16833,1,1542
1469,2021/10/01 15:00:00+00,Unknown,70,20615,43,16876,5,1547
1470,2021/10/02 15:00:00+00,Unknown,22,20637,8,16884,1,1548
1471,2021/10/03 15:00:00+00,Unknown,56,20693,54,16938,10,1558
1472,2021/10/04 15:00:00+00,Unknown,23,20716,9,16947,4,1562
1473,2021/10/05 15:00:00+00,Unknown,25,20741,28,16975,1,1563
1474,2021/10/06 15:00:00+00,Unknown,22,20763,24,16999,2,1565
1475,2021/10/07 15:00:00+00,Unknown,19,20782,17,17016,1,1566
1476,2021/10/08 15:00:00+00,Unknown,57,20839,43,17059,11,1577
1477,2021/10/09 15:00:00+00,Unknown,53,20892,25,17084,2,1579
1478,2021/10/10 15:00:00+00,Unknown,33,20925,41,17125,1,1580
1479,2021/10/11 15:00:00+00,Unknown,5,20930,10,17135,8,1588
1480,2021/10/12 15:00:00+00,Unknown,22,20952,18,17153,3,1591
1481,2021/10/13 15:00:00+00,Unknown,19,20971,24,17177,2,1593
1482,2021/10/14 15:00:00+00,Unknown,14,20985,23,17200,3,1596
1483,2021/10/15 15:00:00+00,Unknown,35,21020,33,17233,1,1597
1484,2021/10/16 15:00:00+00,Unknown,26,21046,18,17251,4,1601
1485,2021/10/17 15:00:00+00,Unknown,34,21080,20,17271,,1601
1486,2021/10/18 15:00:00+00,Unknown,12,21092,8,17279,17,1618
1487,2021/10/19 15:00:00+00,Unknown,16,21108,14,17293,3,1621
1488,2021/10/20 15:00:00+00,Unknown,24,21132,21,17314,4,1625
1489,2021/10/21 15:00:00+00,Unknown,11,21143,20,17334,1,1626
1490,2021/10/22 15:00:00+00,Unknown,36,21179,33,17367,9,1635
1491,2021/10/23 15:00:00+00,Unknown,38,21217,17,17384,8,1643
1492,2021/10/24 15:00:00+00,Unknown,58,21275,19,17403,3,1646
1493,2021/10/25 15:00:00+00,Unknown,11,21286,16,17419,8,1654
1494,2021/10/26 15:00:00+00,Unknown,26,21312,14,17433,8,1662
1495,2021/10/27 15:00:00+00,Unknown,37,21349,16,17449,7,1669
1496,2021/10/28 15:00:00+00,Unknown,28,21377,16,17465,2,1671
1497,2021/10/29 15:00:00+00,Unknown,30,21407,29,17494,13,1684
1498,2021/10/30 15:00:00+00,Unknown,14,21421,11,17505,4,1688
1499,2021/10/31 15:00:00+00,Unknown,14,21435,14,17519,4,1692
1500,2021/11/01 15:00:00+00,Unknown,13,21448,5,17524,3,1695
1501,2021/11/02 15:00:00+00,Unknown,27,21475,13,17537,9,1704
1502,2021/11/03 15:00:00+00,Unknown,66,21541,16,17553,5,1709
1503,2021/11/04 15:00:00+00,Unknown,20,21561,5,17558,7,1716
1504,2021/11/05 15:00:00+00,Unknown,56,21617,35,17593,4,1720
1505,2021/11/06 15:00:00+00,Unknown,45,21662,19,17612,2,1722
1506,2021/11/07 15:00:00+00,Unknown,36,21698,12,17624,5,1727
1507,2021/11/08 15:00:00+00,Unknown,12,21710,2,17626,8,1735
1508,2021/11/09 15:00:00+00,Unknown,24,21734,7,17633,5,1740
1509,2021/11/10 15:00:00+00,Unknown,28,21762,7,17640,1,1741
1510,2021/11/11 15:00:00+00,Unknown,18,21780,7,17647,5,1746
1511,2021/11/12 15:00:00+00,Unknown,61,21841,34,17681,17,1763
1512,2021/11/13 15:00:00+00,Unknown,60,21901,24,17705,6,1769
1513,2021/11/14 15:00:00+00,Unknown,25,21926,11,17716,3,1772
1514,2021/11/15 15:00:00+00,Unknown,18,21944,2,17718,2,1774
1515,2021/11/16 15:00:00+00,Unknown,28,21972,6,17724,5,1779
1516,2021/11/17 15:00:00+00,Unknown,32,22004,16,17740,4,1783
1517,2021/11/18 15:00:00+00,Unknown,30,22034,10,17750,7,1790
1518,2021/11/19 15:00:00+00,Unknown,50,22084,13,17763,8,1798
1519,2021/11/20 15:00:00+00,Unknown,52,22136,20,17783,1,1799
1520,2021/11/21 15:00:00+00,Unknown,25,22161,4,17787,1,1800
1521,2021/11/22 15:00:00+00,Unknown,36,22197,8,17795,3,1803
1522,2021/11/23 15:00:00+00,Unknown,26,22223,8,17803,5,1808
1523,2021/11/24 15:00:00+00,Unknown,19,22242,5,17808,1,1809
1524,2021/11/25 15:00:00+00,Unknown,2,22244,,17808,,1809
1525,2021/11/26 15:00:00+00,Unknown,9,22253,1,17809,1,1810
1526,2021/11/27 15:00:00+00,Unknown,29,22282,6,17815,,1810
1527,2021/11/28 15:00:00+00,Unknown,56,22338,26,17841,,1810
1528,2021/11/29 15:00:00+00,Unknown,32,22370,5,17846,2,1812
1529,2021/11/30 15:00:00+00,Unknown,51,22421,14,17860,4,1816
1530,2021/12/01 15:00:00+00,Unknown,29,22450,20,17880,4,1820
1531,2021/12/02 15:00:00+00,Unknown,39,22489,16,17896,2,1822
1532,2021/12/03 15:00:00+00,Unknown,95,22584,21,17917,3,1825
1533,2021/12/04 15:00:00+00,Unknown,110,22694,14,17931,4,1829
1534,2021/12/05 15:00:00+00,Unknown,87,22781,15,17946,2,1831
1535,2021/12/06 15:00:00+00,Unknown,38,22819,7,17953,7,1838
1536,2021/12/07 15:00:00+00,Unknown,35,22854,16,17969,4,1842
1537,2021/12/08 15:00:00+00,Unknown,87,22941,14,17983,4,1846
1538,2021/12/09 15:00:00+00,Unknown,35,22976,6,17989,3,1849
1539,2021/12/10 15:00:00+00,Unknown,54,23030,28,18017,4,1853
1540,2021/12/11 15:00:00+00,Unknown,83,23113,17,18034,1,1854
1541,2021/12/12 15:00:00+00,Unknown,47,23160,13,18047,2,1856
1542,2021/12/13 15:00:00+00,Unknown,30,23190,6,18053,6,1862
1543,2021/12/14 15:00:00+00,Unknown,42,23232,3,18056,18,1880
1544,2021/12/15 15:00:00+00,Unknown,67,23299,6,18062,3,1883
1545,2021/12/16 15:00:00+00,Unknown,31,23330,9,18071,1,1884
1546,2021/12/17 15:00:00+00,Unknown,76,23406,17,18088,6,1890
1547,2021/12/18 15:00:00+00,Unknown,62,23468,5,18093,,1890
1548,2021/12/19 15:00:00+00,Unknown,24,23492,7,18100,,1890
1549,2021/12/20 15:00:00+00,Unknown,35,23527,8,18108,4,1894
1550,2021/12/21 15:00:00+00,Unknown,48,23575,7,18115,4,1898
1551,2021/12/22 15:00:00+00,Unknown,37,23612,5,18120,1,1899
1552,2021/12/23 15:00:00+00,Unknown,33,23645,5,18125,1,1900
1553,2021/12/24 15:00:00+00,Unknown,9,23654,4,18129,,1900
1554,2021/12/26 15:00:00+00,Unknown,28,23682,9,18138,1,1901
1555,2021/12/27 15:00:00+00,Unknown,42,23724,7,18145,1,1902
1556,2021/12/28 15:00:00+00,Unknown,54,23778,5,18150,4,1906
1557,2021/12/29 15:00:00+00,Unknown,25,23803,5,18155,2,1908
1558,2021/12/30 15:00:00+00,Unknown,60,23863,16,18171,1,1909
1559,2021/12/31 15:00:00+00,Unknown,13,23876,2,18173,,1909
1560,2022/01/01 15:00:00+00,Unknown,14,23890,4,18177,,1909
1561,2022/01/02 15:00:00+00,Unknown,15,23905,5,18182,,1909
1562,2022/01/03 15:00:00+00,Unknown,6,23911,6,18188,,1909
1563,2022/01/04 15:00:00+00,Unknown,41,23952,14,18202,1,1910
1564,2022/01/05 15:00:00+00,Unknown,29,23981,12,18214,2,1912
1565,2022/01/06 15:00:00+00,Unknown,41,24022,13,18227,4,1916
1566,2022/01/07 15:00:00+00,Unknown,74,24096,14,18241,,1916
1567,2022/01/08 15:00:00+00,Unknown,148,24244,21,18262,1,1917
1568,2022/01/09 15:00:00+00,Unknown,25,24269,1,18263,,1917
1569,2022/01/10 15:00:00+00,Unknown,18,24287,4,18267,2,1919
1570,2022/01/11 15:00:00+00,Unknown,24,24311,4,18271,2,1921
1571,2022/01/12 15:00:00+00,Unknown,56,24367,13,18284,2,1923
1572,2022/01/13 15:00:00+00,Unknown,47,24414,11,18295,2,1925
1573,2022/01/14 15:00:00+00,Unknown,61,24475,24,18319,4,1929
1574,2022/01/15 15:00:00+00,Unknown,108,24583,7,18326,,1929
1575,2022/01/16 15:00:00+00,Unknown,33,24616,1,18327,,1929
1576,2022/01/17 15:00:00+00,Unknown,5,24621,2,18329,,1929
1577,2022/01/18 15:00:00+00,Unknown,27,24648,3,18332,3,1932
1578,2022/01/19 15:00:00+00,Unknown,39,24687,16,18348,3,1935
1579,2022/01/20 15:00:00+00,Unknown,43,24730,12,18360,,1935
1580,2022/01/21 15:00:00+00,Unknown,64,24794,19,18379,5,1940
1581,2022/01/22 15:00:00+00,Unknown,83,24877,10,18389,,1940
1582,2022/01/23 15:00:00+00,Unknown,80,24957,18,18407,6,1946
1583,2022/01/24 15:00:00+00,Unknown,24,24981,5,18412,,1946
1584,2022/01/25 15:00:00+00,Unknown,21,25002,3,18415,1,1947
1585,2022/01/26 15:00:00+00,Unknown,26,25028,8,18423,1,1948
1586,2022/01/27 15:00:00+00,Unknown,39,25067,10,18433,,1948
1587,2022/01/28 15:00:00+00,Unknown,61,25128,16,18449,1,1949
1588,2022/01/29 15:00:00+00,Unknown,59,25187,24,18473,1,1950
1589,2022/01/30 15:00:00+00,Unknown,84,25271,6,18479,,1950
1590,2022/01/31 15:00:00+00,Unknown,25,25296,4,18483,,1950
1591,2022/02/01 15:00:00+00,Unknown,9,25305,8,18491,,1950
1592,2022/02/02 15:00:00+00,Unknown,21,25326,3,18494,,1950
1593,2022/02/03 15:00:00+00,Unknown,15,25341,11,18505,,1950
1594,2022/02/04 15:00:00+00,Unknown,41,25382,24,18529,,1950
1595,2022/02/05 15:00:00+00,Unknown,6,25388,1,18530,,1950
1596,2022/02/06 15:00:00+00,Unknown,14,25402,1,18531,,1950
1597,2022/02/07 15:00:00+00,Unknown,18,25420,5,18536,3,1953
1598,2022/02/08 15:00:00+00,Unknown,14,25434,6,18542,,1953
1599,2022/02/09 15:00:00+00,Unknown,16,25450,6,18548,,1953
1600,2022/02/10 15:00:00+00,Unknown,13,25463,7,18555,,1953
1601,2022/02/11 15:00:00+00,Unknown,30,25493,16,18571,1,1954
1602,2022/02/12 15:00:00+00,Unknown,20,25513,5,18576,,1954
1603,2022/02/14 15:00:00+00,Unknown,9,25522,2,18578,,1954
1604,2022/02/15 15:00:00+00,Unknown,9,25531,3,18581,1,1955
1605,2022/02/16 15:00:00+00,Unknown,16,25547,6,18587,,1955
1606,2022/02/17 15:00:00+00,Unknown,7,25554,6,18593,1,1956
1607,2022/02/18 15:00:00+00,Unknown,18,25572,18,18611,3,1959
1608,2022/02/19 15:00:00+00,Unknown,11,25583,4,18615,,1959
1609,2022/02/20 15:00:00+00,Unknown,6,25589,1,18616,,1959
1610,2022/02/21 15:00:00+00,Unknown,7,25596,6,18622,1,1960
1611,2022/02/22 15:00:00+00,Unknown,6,25602,6,18628,,1960
1612,2022/02/23 15:00:00+00,Unknown,9,25611,5,18633,,1960
1613,2022/02/24 15:00:00+00,Unknown,11,25622,1,18634,1,1961
1614,2022/02/25 15:00:00+00,Unknown,20,25642,21,18655,1,1962
1615,2022/02/26 15:00:00+00,Unknown,3,25645,3,18658,,1962
1616,2022/02/27 15:00:00+00,Unknown,2,25647,4,18662,,1962
1617,2022/02/28 15:00:00+00,Unknown,6,25653,2,18664,,1962
1618,2022/03/01 15:00:00+00,Unknown,3,25656,2,18666,,1962
1619,2022/03/02 15:00:00+00,Unknown,14,25670,5,18671,1,1963
1620,2022/03/03 15:00:00+00,Unknown,7,25677,5,18676,,1963
1621,2022/03/04 15:00:00+00,Unknown,10,25687,15,18691,,1963
1622,2022/03/05 15:00:00+00,Unknown,1,25688,,18691,,1963
1623,2022/03/07 15:00:00+00,Unknown,2,25690,1,18692,1,1964
1624,2022/03/08 15:00:00+00,Unknown,3,25693,2,18694,,1964
1625,2022/03/09 15:00:00+00,Unknown,4,25697,3,18697,,1964
1626,2022/03/10 15:00:00+00,Unknown,,25697,1,18698,,1964
1627,2022/03/11 15:00:00+00,Unknown,4,25701,7,18705,,1964
1628,2022/03/12 15:00:00+00,Unknown,1,25702,,18705,,1964
1629,2022/03/13 15:00:00+00,Unknown,,25702,1,18706,,1964
1630,2022/03/14 15:00:00+00,Unknown,,25702,2,18708,1,1965
1631,2022/03/15 15:00:00+00,Unknown,6,25708,4,18712,,1965
1632,2022/03/16 15:00:00+00,Unknown,8,25716,6,18718,,1965
1633,2022/03/17 15:00:00+00,Unknown,1,25717,2,18720,,1965
1634,2022/03/18 15:00:00+00,Unknown,5,25722,5,18725,,1965
1635,2022/03/19 15:00:00+00,Unknown,,25722,,18725,,1965
1636,2022/03/20 15:00:00+00,Unknown,,25722,1,18726,,1965
1637,2022/03/21 15:00:00+00,Unknown,,25722,2,18728,,1965
